----------------------------------------------------------------------------------------------------------------------------------------------------------------------------------------?---XXXXXX------
--------------------------------------------------------------------------------------------------------------------------------------------------------------------------------------------------------
--------------------------------------------------------------------------------------------------------------------------------------------------------------------------------------------------------
-----------------------------------------------------------------------------------------------o--------------------------------------------------------------------------------------------------------
-------------------------------------------------------------------------------------------------------------------------BBB----------------------------------------------------------------------------
--------X---------------------------------------------------------------------------------------------------------------------------------------------------------------------------------------------X-
------------------------------------------------------------------------------------------------------------------------------------------------------------------------------------------------------X-
-----------------------------------------------------------------------------------------------------------------------------------------------------------------------------------------------------XXv
----------------------------------------------------------------------------------------------------------------------------------------------------------------------------------------------------XXXf
---------------------------------------------------------------------------------------------------------------------------------------------------------------------------------------------------XXXXf
--------------------------------------------------------------------------------------------------------------------------------------------------------------------------------------------------XXXXXf
--------------B----------------------------------------------------------------------------------------------------------------------------------------------------------------------------------XXXXXXf
-----------------------------------------------------------------------------------------------------------------------------------------------------------------------------------------------BXXXXXXXf
---------o-------------------------------------------------------------------------------------------------------------------------------------------------------------------------------------XXXXXXXXf
m---------------------------------------------------------------------------------------------------------------------------------------------------------------------------------------------XXXXXXXXXX
XXXXXXXXXBXXXXXXXXXXXXXXXXXXXXXXXXXXXXXXXXXXXXXXXXXXXXXXXXXXXXXXXXXXX-----XXXXXXXXXXXXXXXXXXXXXXXXXXXXXXXXXXXXXXXXXXXXXXXXXXXXXXXXXXXXXXXXXXXXXXXXXXXXXXXXXXXXXXXXXXXXXXXXXXXXXXXXXXXXXXXXXXXXXXXXXXXXXX
