--------------------------------------------------------------------------------------------------------------------------------------------------------------------------------------------------------
--XME---B-o-B-M-B----X--EM-----XXX---oB--------M-------ooE--M--MM------M----?-X?-MX-EooEXM---E?---B--?E-Bo------E--oMBB--B--X?o--Mo---X-o-E--o----o---EB-o----E---XM-Eo----BMM---B-EX----M---X?BB--X-?M-
-X---E-EB-oM-Bo--B----M---X-B---------X?B--BBo---BM-EX-Xo-?---M-E----X-XM---X-E--M---B-------BMoE-?----E--o-B--o?--o-E--B-M------o--E--E---E--o---EM-EMM--??-XE--oM-Mo--E-E-B?M----B-?-BM-M----B?-?o--B-
---BM-E------E-o-MME-o-o----o--o-X--oME--X--?---------?EB--M--?--M--o-B--EX----X-----M-M-XM---E?-o-M-B-B--B--oBo----------EM---?E---E---MBoE--M--------M---------Mo----?-M-----?E-B?BXXEE---EM--E--o-M--
-X-----BB-oM----BooB----EX------------M--M------Eo-X?--o-M-M?-EBE-Bo--?--M??-----E-Bo-M-----B-X-E------M-E-E--------X-M-X--BM---E-------EM-M----B--X?o---Eo--MM---X?-MBM--X-----E?---oE---------?-?MBE--
-oE-X?--M---X-M------XBMM-EM-ME-o--E-X-X-B-E---EM--ooB--B-X-o?o-M--E-M-?oX-BB-?E-XBE-E-oo-EXBEXX?E-o-X-----M-X-E--o----o-X-M-------EM-M--X---X--oo-----?X-E--X---X--?--o-------MX----oEE-?---M-E--------
-M?BM--BEMMX----------M?X----XM?--?-XM?--?--?--MMM--M-o--B---M-----oo--MXE-M??--EB---X-M-?o---B------XB-?EoEE----------X-?B-o?-----o---?----oMM-EB-o---Eo---BEE----E-o-E?--o-E------BM---XME--E---E--M--
--MM-B--ME-EM?-B-X---M---B-M-?-M----?-oM-E?--o----M----B-B-M--E-BM---oB--X-?M---------E-B----BB--??E--?---o-EMB-X-E-BXo--oM-B--MB---?--XE----??--E----M---M--BB----X--X?EXXB--o--?-B--?XEo--MB-B-B-MoMMv
--oMX-----BEoM??---E-M-o-?---X-M--B---E---Xo---B--E-o----MX-------M---EMo-EM--?---------M---E-E-M-o-o-BM---E---B--B--M-----XMBE--?-M-B-----E-B-M---o---E-------MXM-B-o-o-E--?E---BoE--o--M--M--EEM---oof
-----o-----E?M--------M--o--E---E--?E---B--B-----MEE-B-B---oBXE-M---M-----?-MM---X-o---X-MX----BoBX---E-?-oM-X?--------MMoB-XM?MX--MM--E-oo?--?-------o-oX?--B---------------E-X--o?---M-MXM-M-----o--Xf
--M-B-------BX---M?---M------M---M---?----o-Eo--ME---B---E--oE-EM----E--Bo-o--B---??M-?Mo-M-o-o---ME--E--B--MX-EEE--oM-?--o-ME-o-MEXE-?M--o-M?---X-----MBBo?o-?B-E---oE-B---Xo--------??--------B--M--Xf
----M----o----E----MoMME-----B-?B-M?-X-----E-Bo----------MM---ME---MX----Eo-?oEB-M--M--XX-X?---B--E-?--MoX------M-oo-----oE---BoM---------Mo-E--oMo---oEEE--oEX--o-M-M-X--MBM--Mo----M-X?o----EB----BM?f
---MX--EMo?M?----X-M--?EB---?-E-M?--X---?-M-ooo--M?XM----?BBE-E----E--EoEE-E?-B-----EXX-o-M-o?M----XBM-B-o-o-E?E--MMBEB-X---M--X---X-M-Mo-?oM--MEE---X--X---M-?-?----X---?--?---oBXX---XM-----XX--X---Xf
-?-XB---B-----o-X??M?-M---o?M---ME-X-B---B-M-M?X------M-ME----o-?M?M--BXo--?X------M--EE-MM--XX----?--X-oBo--E------o-MBMo---M----?--XM---XX--?MoE------E-B-MEB-B---o-MX-B--E----?o---X-EoXBX?---M--oE?f
mM-BBEE?--E-M--??-o-BM?X?oE-X?---EM---M---X?M-BoX-Mo----E?-oBoBB?---X---MM----?-E----X--Eo-E--MMo-EB------------?----M---?-E-M-M-X---E---oX---BB-B--o-oX-X-B-----oEE--?o-oM-?-Eo-X---BB--M---B------?-BX
XXXXXXXXXXXXXXXXXXXXXXXXXXXXXXXXXXXXXXXXXXXXXXXXXXXXXXXXXXXXXXXXXXXXXXXXXXXXXXXXXXXXXXXXXXXXXXXXXXXXXXXXXXXXXXXXXXXXXXXXXXXXXXXXXXXXXXXXXXXXXXXXXXXXXXXXXXXXXXXXXXXXXXXXXXXXXXXXXXXXXXXXXXXXXXXXXXXXXXXX
