--------------------------------------------------------------------------------------------------------------------------------------------------------------------------------------------------------
-oM-----B-ooX?Moo-----E---?------oE--?M-?------o--EoX?--oEE----M?-o----M-----?M-----E---X-oM--?---XBooMM----?-M-X--BM----M-BM?-M--?---o-o------B-o?o-E-X--?------EE---o--oM-B--B-X------o---?B?--E--M-B-
----M--EX--E-Bo-EB-M-EMM---MB---o--?Moo-B--?-o------?-MBE?--M?X-M--X-MXX---M-----MMBMM-MM--------M----BoE---B-Xo--o--BXM?B--Xo--?E--X--E-o-?B--?---?ME-M---M--?XMo--MM-M-M----MX----M----------E--M-X---
-E--?--MBB-E---?-?E-M--M-X-M-?-----ooXE-BM?E----E-----E---M--X---Eo---X---X-----?-------M-B----E-o-B-o-X---X??--------B---?-?B--E---o---M?-E--M-o-E--?-M-----------E--M------o?----M-oXoE-EB---------BX-
-X?----BBEoX---M--o-o----MXB------MX----o---M--MEM-X-M-Eo---MM-Eo-B------EE----M----o--Eo----oX--------M?Bo-X-M---E-----X??-X-?EE-XEMM-?--oMMM-o--X-M--E--o---oMM----M-------M--oo-X--EM----Mo----?-X-B-
--EX----o?----?--------M---M-o---?o?-X---B-BE-XE-M-?BB------M-o-o--?-oo--X-XMo-E-Xoo---o--X??M-XEE--o-o---B--o-X------M-??MM----?-XE------o--Xo---o----B---------o--?----XM--BoMoB----?---oBEo-??---B---
-?M--?-??EB-----M----M------EB------?M---MME----E----?B-----X?-BE-ME---o-----B-----E------?X-ME?-?--M-B--E----EB--oo-oX?-MB-E-oo-?----EEBM---?M-M--Xo--BX---MME------?---M---E--M-??M-------o--o--MMX-M-
-E-BM----E?EM-MM-B------B-MBX--M-M-Bo-X?-------Xo-?-MM--M?o-E---------B-------X-X--------------?--Xo?-------o-----E-B----BMM---M-??-ME-EE--------Eo---M-?--E----M---X-?oE-?--X--o--M-o--B---B--?-o--MMMv
---M-E---B-?---E?-XE--o-----MXoXMEM--BEX---o--XE--X------MoMoM---?---M-oo?E-X--------X--M---o-E-M---oMMME--M--oX--BX?-XB-E-X---MBMoM-B-----EM--?----o--E-----oBX-M-M----EE-----?--o-Mo-MM--EXBo?------?f
-B--E--?M----o--------MX----E-EM------oE-B---XM-?MEEB--B--??BB-o-o-----EX-?--MX---E----o-M-E----o--M-----Eo--MMM?-X--M---o--M--Bo---MB-?--o-----oM-BMX--EM---o----Xo--o----B-MXX-------o-B-M--XX----BMMf
----E--B--MEMXXM-oE-o-X--MXXM----o----X-M---?---ME?-----B----E-XMX---E--X-----ME-B?----X?--MXB-BX--B---------B-EoE--oMM-E-oB-X-----XE-M-E--?-o-?---------?o--E?B-o-o-X--Xo------------E-o--Eo--BXXMMXB?f
----M-o-B-----X-X--?MBM?-----B----B---B------B------------E-B--o---X-B---EX--o-B-M-----B--o?--E-E---?--MM---B---B-Mo--oo---o----M-?--BB---ME---X------E-Eo--XEXE--BM-o?-?---MM---oX--------E----?---?E-f
------Bo--MM--M-M---oo-E--B-----MM----?-?oM---EM---X-BMM--?oM--X--EMX--oX--??-X--o---XEB-MM--o-------M-B-----EBM-o--M-ooX----EX--------X?--o-MoB?E??-EX-XM--B-E-?-M--?-----BEM-?-E--M-EX--X--B-E--B--BEf
-?--B-M-Bo---BM--oo-Eo--E-oo-ME-EX-X--X-M--E-M--oB?-X-M--E-E-oo----E-M-?--o?-ME--?--E-E----MM--B---?M-----?o-B------M--BB-?--X??--E----Mo-X-M-X--o---E-?MMB-XX----------M-------------B--X?--X?--?---??f
m-?--E------M--?--oMB--B--?---B?M-MX-BM-M-B------Moo-?Mo--o-X--M?---X---MEo---?MB----X-XX-ME-X-XB--B-XBX------oE?MEM----B?-E?-B-EMBE-M--M-XE---?BB?M--EXE--B-----o--?-M-XooM-MEoM------MoM-M?B----M??-BX
XXXXXXXXXXXXXXXXXXXXXXXXXXXXXXXXXXXXXXXXXXXXXXXXXXXXXXXXXXXXXXXXXXXXXXXXXXXXXXXXXXXXXXXXXXXXXXXXXXXXXXXXXXXXXXXXXXXXXXXXXXXXXXXXXXXXXXXXXXXXXXXXXXXXXXXXXXXXXXXXXXXXXXXXXXXXXXXXXXXXXXXXXXXXXXXXXXXXXXXX
