----------------------------??-----------------------o-------------------------o-----------------------------------------------------------------------------------------------------X------------------
--------------------------B----------------------------o---------------------------------------------------------------------------------------------------X------------------------------------------?-
-----------------------?X???-----------------------------------------------------------------------------------------------------------------------------------------o----------------------------------
------------------------------------------------------------------------------------------------------------------------------------------------------B-------------------------------------------------
-------------------------------------------------------------------------------------------------------------------------------------------------------------------------------B------------------------
--------------------------------------------------------------------------------------------------------------------------------------------------------------------------------------------------------
----------------o---------------------------------------------------------------------------------------------------------------------------XX----------------------------------------------------------
--------------------------------------------------------------------------------------------------------XXXXXXXX------------------------------?---------------------------------------------X----------v
--------------o----------------------------------------------------------------------------------------------------------------------------------------------------------------------------XX----------f
----------------------------------------------------------------------------------------------------------------------------------X----------------X--------------------------------------XXXXXXXXX----f
-------------------------o---------------------------------------------------------------------------------------------------------------------------------------X-----------------------XXXX----------f
----------------------------------------------------------------------------------------M------------------------------------------------------T----------------------------------------XXXXX----------f
-------------------------------------------------------------------------------------------------?-------------------------BBBBBB-------??-----|---------------------------------------XXXXXX----------f
---T-------------------------------------------------------------------------------------------------------------------------------------------|----------------------------T---------XXXXXXX----------f
m--|--------------------------------------E--------------------------------------------------------?---------------------------EE--------------|----------------------------|--------XXXXXXXX----------X
X--|----XXXXXXXXXXXXXXXXXXXXXX------XXXXXXXXXXXXXXXXXXXXXXXXXXXXXXXXXX---XXXXXXXXXXXXXXXXXXXXXXXXXXXXXXXXXXXXXXXXXXXXXXXXXXXXXXXXXX-------XXXXX|-------------XXXXXXXXXXXXXXX|XXXXXXXXXXXXXXXXXXXXXX----X
