------------------------------------------------------------------------------------------------------------------------------------------------------------------------------------------o-------------
-X----------------------------------------------------------------------------------------------------------------------------------------------------------------------------------------------------X-
--------------------------------------------------------------------------------------------------------------------------------------------------------------------------------------------------------
-----------------------B--------------------------------------------------------------------------------------------------------------------------------------------------------------------------------
------M----------------------------------------------------------------------------------------------------------------------------o-----------B------------------------------------------X------XXXXXX-
-------------------------------------------------------------------------------------------------------------------------------------------------------------o---------------------------XX--M----------
----------------------------------------------------------------------------------------------------------------------------------------------------------------------------------------XXX-------------
--------------------------------------------------------------------------------------------------------------------------------------------?-----------------------------o------------XXXX--------?---v
--------------------------------------------------------------------------------------------------------------------------------------------------------------------------------------XXXXX------M---o-f
-------------------------------------------------------------------------------------------------------------------------------B-----------------------------------------------------XXXXXX------------f
-----------------------------------------------------------------------------------------------------------------------------------------XXX---------------?------------------------XXXXXXX----X-------f
------------------------------------------------------------------------------------------------------------------------------------------------------------o----------------------TXXXXXXX--------????f
-----o----------------------------------------------------------------------------------------------------------------------------------------------------------------------------X|XXXXXXX------------f
------------------------------------------------------------------------------------------------------------------------------------------------o-------------------o-T--------X-XX|XXXXXXX-----------Tf
mE-E-E-------------X--------------X-----------------------------------------------------------------------------------------------------------E-E---------------E-----|----o----XXX|XXXXXXX------EE??E|X
XXX--X---XXXXXXXX-------?XXXXXXXXXXXXXXXXXXXXXXXXXXXXXXXXXXXXXXXXXXXXXXXXXXXXXXXXXXXXXXXXXXXXXXXXXXXXXXXXXXXXXXXXXXXXXXXXXXXXXXXXXXXXXXXXX-----XXXXXXXXXXXXXXXX------X|XXXXXXXXXXXX|XXXXXXXXXXX---????|X
