---B------------B-----------------o----------------------------B----B-----------o--------------------------------------------------------------------------------B--------------------------------------
------B---------------------------------------B---------------o--------------------------------B---------------B----------------------------o-------------B------------B--------------------------------
------------------B--------B------B---o-B-----------B--o-----------------------------------B------------------------------------o--------------------------------------------------B--------------------
--------------------------------------------------------------------------------------------------------------------------------------------------------------------B-------------B---------B-----------
-----------------------------------------------------------------------------------------------------------o--------------------------------------------------------------------------------------------
------------------------------------------B----------B-------B-----o---------------------------B------------------------------B--B---------B-o--------------B-------------------------------------------
-----------------------------------------------------------------------------B--------------------------------------------B-----------------------------------------------------B-----------------------
-------------------------------------------B-------------------------------------------------------------------------------------B------o--------------------------------------------------------------v
---------------------------------------------------------------------B-------------M-------------B----------------------------------------------------------------------------------------------------of
-----------------B-----------------------------------B-----------------------------------------------------B------B-----------B-----------------------B----------B------------o------------------------f
-----B-------------------------------------------------------o------------------------------o-------------------------------B--------------------------------------------------------------------------f
-----B---------------------------------M-T-------------------o---------------------------------T--------------B---------------------------------------------------------T-----T------------------------f
---------------?------------T------------|----T-----T-----B------------------------T-----T-----|-----M------------T-----------------------T-o----T----------------------|-----|------------------------f
---------T---T--------------|---------T--|----|-----|---T---TM---T---T--oT---------|BB---|-----|--T---------------|-----------------------|------|----------------------|-----|o-------T-XT------------f
m--------|---|--------------|---------|--|----|-----|---|---|----|---|---|----E----|-----|-----|--|------------T--|----T---T-----------B-B|------|--T-------------------|-----|---T----|--|----T-------X
XXXXXXXXXXXXXXXXXXXXXXXXXXXXXXXXXXXXXXXXXXXXXXXXXXXXXXXXXXXXXXXXXXXXXXXXXXXXXXXXXXXXXXXXXXXXXXXXXXXXXXXXXXXXXXXXXXXXXXXXXXXXXXXXXXXXXXXXXXXXXXXXXXXXXXXXXXXXXXXXXXXXXXXXXXXXXXXXXXXXXXXXXXXXXXXXXXXXXXXX
