----------------------------------------------------------------------------BB---------------XXXXXXXXXX-------------------------------------------------------------------------------------------------
---------------------------B----------------------------------------------------?????------------------------------B-----?-----------------------------------------------------------------------X------
-----------------------------------------------------M------------------------------M------??----B--X---------------------------------------------------------------------------------------------------
------------------------------------------------------------------------------------B-------X----------------------------------------------------------o-------------B------------------------------o---
--------------------------o------X------------------------------------------------------------------------------------o---------------------------------------------------------------------------o-----
-------------------------BBBB----------o--------------------------MBBB------o---------------X-----------------------------------B-----------------------------------------------------------------------
-------------------------------------------------------------------------M----------------------------------------------M-------------------------------------------------------------------------------
-------------------------------------------------------BBBB--------------------X-------?--------------------------------------X------------------------------------------------BBBBB---o-?-------o-XXXXv
---------------------------------------------------------XX-------------------------M---???????-----X------------B-----------------X-------------------------------------------------------------------f
---BBBBBB----------------------M-----------B---------?---------------------------------XXXXXXXXXXXXXX--------------------------------------------------------------------------------------------------f
------------------------------o-------------------------------------------------------------------XXX---?--------------------o---BM--------------------------------------------------------------------f
---------------------------------------------------------------------------------------X---T-o---XXXX-T-------------------------X----------------------?-----------------------------------------------f
------X------------------------------BB----------------------------------------------------|----XXXXX-|------------------------------------------------------------------------------------------------f
------XX----------------???????--------------------------B----------------------?----------|--oXXXXXX-|-????-----T---????-?-------------------------------------------------------------BBB---T--------f
mE----XXX------------E----------E-----B-----------------------------------E--E-o----------o|--XXXXXXX-|-------E--|-E------X-------E------E-----E----------------o--X-------------------------E|-E------X
XXXXXXXXXXXXXXXBBBBBBBBXXXXXXXXXXXXXXXXXXXXXXXXXXXXXXXXXXXXXXXXXXXXX???---o--?BBB-X-XXXXXXX|XXXXXXXXXB|-XXX?X---X|XX-----XXXXXXXXXXXXXXXXXXXXXXXMXXXXXXXXXXXXXXXXXXXXXXXXXXXXXXXXXXXXXXXXXX---|--XXXXXXX
