--------------------------------------------------------------------------------------------------------------------------------------------------------------------------------------------------------
-BX----X-B-oo-X?X?-----BMo----o-??------oM----oE--oXB----E----oBMo?X----M-B---BX-E---?E--B-B-o-o?--o--MMBEooX-?---E-------E----?XB----Eo--M?-B-------?EoM-------E--B--MEB---EX-E---B?-E?--o-------X-----
-X-M------M?---X--M----?-MB-oM--M-EX-EX--?-MB----EEM----E--XXoX--E---E----B-?-EX-X-?-B-XM------BM-XoBE----M----?-----?--M-M----------?BE--ME--o-E---X-X---o------?-?M-o----B--M-E---E-?--XT---?--X-X-M--
-B--E-MM--o--M-E?--M--X-o--?--EE----BX-Xo---X-B-?-?-M-X---o-T-?-X-M-----M-E----M---M-B--X?MB-----B-o-B-------o-M-BX--------XX-Xo-B--o--E-?B-M-o?--o?----E-----E-X-----M------E--B---B---o---?-E---XE-BM-
-oE--oo---o---BT--M---------E---?Mo?---XE-EEB-B---?---------X-o----E------X-BME--Mo|-MB---o-----M-------Xo-B--Xo--?-?Eoo-EEB-oXo--M?M----E------oBT?B---B----M------X-oX-B-E--B-B---?o---?o---E-X--B?---
--M---BEo--Xooo-o-BB-B?XM-BBM--BM----XEMX--o--XBE-|--MX---o----X--E-o-Mo---o-?E--------E--X?o-------oEX------E----o---?-------o?--E-MX--X---o-oX-Eo-E----------?B-X----B--X-M?-----o----ME----X-E---?-M-
-M--BEB--E-EEXoB------o-?--o---MB-B?--o--?-?-?E----E--X--E---?XM-B?--Mo-oB----M-B------B-?-----M-B---X-X--B-o---M-----------o-----M--?-B--B----EB?-----B-----o-o-M-BE---MME--------Bo-----M-M--?EB------
--E---o-----o------?oBB-------?-EE---E--?--B-oBME-?oXX------X----XX-----M-o-?--X-?----oXoo--------oX-?-------XE---EX--XB----------Eo--M------E-EB?---------BMo-o-T---------?--M-E---M?-?-?-M----E-E-?-Bv
-M--B-----?E----oXX---E---X?B-?-oo---EE----MB----X-B---X-----XX------?BX-X-?o--------E--|o-E---o-BE--T-B--o--B----|-oX------B------------oM-o---E----??-?--X---MM--MBE-----?-------B-----E--B---E----E?f
-MM-EoB---------E?-E---o------XM?-?-B--?----M?M-----o?-M--E----ooM-o----X-M-T-oE-----o----o--o-o-XX-EX-o-----B-?-B---M?-E--M??--B--M-o----X?|---E-------M-M?---M---X-T---M--M-?E?X?E-?--Mo---oMBB-?B-BMf
-X------------EM-E---B-?----EooX--o----X--------E-oE-----BB--B---o----B--o-M--XTEo-X-E?M-?-MMEM-EX?--o--??----oE-----M--o--BoMMB-BoE?X---E?|-----EM--B--X---MBB--XM--------oo--TT---EE-ooTo-MXo---XTMoEf
--?-B---?--oB--E-ooBo--M?B?-B--E----M------M-M--?--B---?oBX--MXXo---E---BT-----o-MM-E-X---B-M--X-------EoB-----?X--oE----E-----??--?------M---------E------E-EM--E?---EE--M---EEE----X--B---?---B-B---Bf
--M?--Mo---o---Eo-EM?--MBBEE--E---o----E--B--M-X?BX----M---M---oB---B-M-EM----o--XX?-?X--X-oM------E-??---o-M-?XX-B--?-ME----------oo----?M---?--?-o----X?-?M?----E--E--o?-?-E-M-X---o-----?E----Bo---?f
-EoX?E--B---?---------BM-X--?--XMEXE-X-B---o---XoXM--?--BMM------oXB--M--EE--X--BBBo----o--E---o-?M--oTB--B-X-----B-----E---MM--?-?---oX-XM-----------------?-?---E------------?X------B----Bo----X----f
m---E??EBX?-o-----M-------B?E?BBBM-M----X-M-E-oME--BM-----B---M---B?-----oMB-----B-o-XX-----E-o--EXo---M--ME--M-oBo-BB?-X---XB--XB-----X-B-BX-oMM-o----M-BX-X--??--B---BE?-oM--E?-----------------B-oE-X
XXXXXXXXXXXXXXXXXXXXXXXXXXXXXXXXXXXXXXXXXXXXXXXXXXXXXXXXXXXXXXXXXXXXXXXXXXXXXXXXXXXXXXXXXXXXXXXXXXXXXXXXXXXXXXXXXXXXXXXXXXXXXXXXXXXXXXXXXXXXXXXXXXXXXXXXXXXXXXXXXXXXXXXXXXXXXXXXXXXXXXXXXXXXXXXXXXXXXXXX
