--------------------------------------------------------------------------------------------------------------------------------------------------------------------------------------------------------
-E--M--------Xo---M--o-M--E-o---M-B---XB-o-M-Bo---oE--X----M---B?---?---M----B-E--?Bo-E----B-------X?--MX-o---------B-X?-XM------E----MMo---BE--------E--o-----o------??-?E-M-oBE-X----?--------X---B---
----M-------X----X-E-M---BB----oM-E--X?----E--------o---?o------E----?-B-Eo--TBB-----------Xo-----X-XB-----X--X-B--EM-?B----XB-o---?--o-?--E---BX--oX-B?-----X--X-E--oX--o----M--M-XEEE--o?M-?-----MXE--
--B?oM-E--??--oXE--M-B----------?---?--E---?-?M?-B--o-oEE-E---E--X------M---?--TX-?-XE-EB---M-M-------oM-EX---?o--X-----M---E-B---?E-M--B----E-E--EoX-Eo--o-M----M?-X-M--M--B--E-----------XB-oo---EB---
---?BE--MoE----------Mo-B-B---o-ME------EME-------XX-XE--E------B------?X--------E-MEE?o--E-?----------?-B-oE----B-X--EE----B----M-|B---B-Bo-------Bo-X-BE--M----?--B-o--o?B-----M?EX-X--X-----M--o-----
--X---o-E--E--o---E-----M--XE---Xo-B-E---MoM----XE-B---X-BE?-E-E-----------?-E----E-oo-|o-TE---o??-BM--B-B--?---XXE--E?--M--X-E-?E--ME-o------BoB?E---Xo--M??o-B---o---Mo??M-EoM------EB-o?M-?-----o----
-?----oo------X-----M--E-o-E?--X---X??---EEX--o----TEEX---Eo---?---B-o------MM-X-----E-XoB-T--M------X--E---E?BEo----oo--E--XE-----o----E-----BE?-----?X---T|-o----ooo--E------o?-EoEX-?--MEX--EoB----o-
---o------M--?-BX--?o-?---M-o-X--?M?---o?---B-XB--M------MB---B---BE---?-Eo-??E---B-o--TB---B--M-BXE------BM---E---?--------E-E-----?----o--M-EM-?BXMB--X----o-X--o-----B-o--M--TM------B-M-oE--E---?E-v
--X--o?E----oM-o--B-BM---E--M---ME?---?Eo-BMoE-------------E--Bo--M-----BBMEE--oB-B--M?-|--X---|?--X--------B-XX-E-------?--XE--------------E-E-M-----E---?-------E--X-EB----?X---------o--B--E-----B--f
---?--E--?----M|---?----EM-X---?XM-------B-X---Xo-M------XE-BX-|E---o-?--T---B---Mo-----E-B-o---E--BEMB--o-?B----o-------ME?----M-X--E-Xo-?M------M--X-X---B-B--oXB----XM?X-o---?--o-M--?M----XMEM-M---f
-EE------M-X-XEMM-----M?-E--E-BE?-----B-X----X-X-----------?--------X-M---M-B-BM-X--oBX--E?-EBMM-?B---------M---M-----o-XM---B--E??E--E-----?--Boo---o--oX---?B---E----------?------Xo-E--E---oX--oEX--f
--E-----XXoX----EM----XB?---?--B-----?--B-M-?o-XMB--?-M-o-XB-?--M-o--oEoEo-o-E-Eo---MB-B--X-----MB|--MX------EM?---oX-X?------B-X-o--?----oX-oBEoT---B--X-M----E?-E--EBB---?--oXX-EM--X-B--BX-XMXE----Bf
-BMM-----B---?X--M-M-EBB-EE--XoX---M--o--Eo----MBX----M-MMBE-----X-------o-X-oo-E-X-?o-BoE--X--oEM-?---XB-B-o--E---oE---M-----M---EX---X-M-X-----EM-B---X?----E?-?oXE|-MBM?---X?-B-B-B----o--X--B-o--M?f
--oBM-----o---------?--XE----E-B-BBMo-?M-?----------X-E----?---?--MX-M----o-M-B-T--X-BME--o-EXEB-----E-o--X----M---M-----?-?----E-EBB-E-MMo------X-----------E-?o-o-E-----M-B----?o-E?-------?--M-X--B-f
mo--XX--B--B-?----M---EX--------?B-T-o--B----X-ME---M--Bo-Boo-E-?--BB----------EX----?-EX-?B-B?--B-----o--M-M--E--B--B-M---E--B--M-?B?-?--?E?----BB---XMo--------MBM--?-----B---B?-??--?ooB-----------?X
XXXXXXXXXXXXXXXXXXXXXXXXXXXXXXXXXXXXXXXXXXXXXXXXXXXXXXXXXXXXXXXXXXXXXXXXXXXXXXXXXXXXXXXXXXXXXXXXXXXXXXXXXXXXXXXXXXXXXXXXXXXXXXXXXXXXXXXXXXXXXXXXXXXXXXXXXXXXXXXXXXXXXXXXXXXXXXXXXXXXXXXXXXXXXXXXXXXXXXXX
