--------------------------------------------------------------------------------------------------------------------------------------------------------------------------------------------------------
-o?E-------M----Xo---?-M----?M----B-oMB-------EMM--B--EB?-oE--oB-X--B----------X-M------------Bo----E----------XE?--------M-E--E--E?------?---EBE-oX--------B---E-XXM--X--Eo-----M--?---M---X--------E--
-X-MEoo-?-BM---E--?----B-E--|o??oEo-oE-oE-X-M-ooBB-E-E------Eo-B---------B----X?-EXE-B---------?-----B-E--B-XEMo--------------?---------E-----B?X------M-B-------M--o-XBE--X----o------BoB---E-E--------
-?MB-oE-Xo---------M-o---B-M-o----?-B--B-----X-X-?-M---------B--B----o---X-E--EooMo------X--?--M---E----o?|-Mo-ooB----X--?--M-MB---------B---XB--?-E---XE-M--?o--XMX-o-E----o-----?-BoMo--B----M--oB--X-
----------X-BM---M---?--B---M-----B--?E-B--B-E---------X-----------E??oB-o----B-o-o--o-----M--E---?-E--?-ooBB--E--E---------BX-?M?ME-E--X?--------------?B---MX---oX--EoBo---E?E-MBX-X-o?M-?B---EB---X--
------------?E?--o--B-X--E--B-M-------EX-M-M----?E?--o---X---?---?--?EBXEB--EE----X--?BEEMX---X-----------M-?-----B-----?M-----o-----E-M-oX----M---??E----?----E----E--EB-E-oE--XEo--?EB--o----------M--
-B--E----B------M--oM--?o---M?----oMM--MX--T-XM--M-B---EM---o------XM-B-Eo-X?o--B---?--E-EE-o-M-----M-??-oEMo----B-?-X-------B---?-----EM------B--M-M-B?-B---XEEM---o-------B--X-M--?-o-----XB--?oB--T--
-BB--------?E---?----M?-----M--X-BX-o--M-------------X-o---B--M-------o--M--?M-X---M-----o-?E-??B-M----?--?-----EM---M-----XE---o-?oE-B---o--?-----X----X?-E-----------X-?EM--?o----o-XM--X---X----o--Mv
---EE----ooo-XX?o---M-X-Mo--------o-?-X--X-B-EM-----E--M----B--X-?ME-------X-?MB---?--E-B---B---XMBM--------XM-------X?E---E-----M-----X---?XM---MM--?-----XM-----B--o----------X-?M---BX--o-?-o-------f
---E-----X---o----E---X-?oXM--M---E----o-----B-M-MB-BXBoo?-?B-XB----M---B--?---M------E--?---E-XoXM-E--o------E-M----------o?-------?X-X--BB----o-X---oo---|--M----X?--M--X---X-M-------o-M--------M?E-f
-M--M---B-----oEE-B--o---?-BX----?----?X-?o--XM-M-o-X---M-M----?--B----BEo---o--E---E-------oE--M-X-M--------E-B--BoX----?-?-ooM-E----------M-?M-?--X----Eo-E?-?-BEE---?-XX-----T?M-o--XMB---o-X-Xo--BXf
-?-M-----------?------oXo-----E---B-E------o---XEEBE----B---?---oMX--o---X?B-E-M----Moo?-E---XMX--X-o--oE-oE?-B?-------?---?--M--o--?-?X-B--o-E-BE----?---T-X-oTM-T-E-?---------B--MB-E----------E-M---f
-T------X----M--M---?-----X?X--B----?-M-X--X---M--B?BoB-EM-B-ME-X--E--E?-----o--------Eo?--M---M-------?o--EXB-X-oo?X--E------M-M--?-oX-MB--B-----X-X-X-X-oo---?-B-B---X-BE--BE-E-X--M---X--M--X---XBXMf
---------o----o-----M---o---XX?-?---M----ooME-MB----------B-X---?------EB--X-E---X----o--E-X--EMM--?----------E--oE--M---------------M----X-----M--o-?-MMoMM----M---oX--?-XE--B-TE-o---------B-o--XX-?-f
moB-----------X------o-B--B-----o--B-MB-----E-------E-E-?-MB-o-oXE--XEoM--o------o----ME-o----?--X?---?MoX-?-oX---BMM---oX-X?----X----o---E-E-E-B--------o----XM--BX----B--?-M-Eo-----E--M-M-B-?--oM?-EX
XXXXXXXXXXXXXXXXXXXXXXXXXXXXXXXXXXXXXXXXXXXXXXXXXXXXXXXXXXXXXXXXXXXXXXXXXXXXXXXXXXXXXXXXXXXXXXXXXXXXXXXXXXXXXXXXXXXXXXXXXXXXXXXXXXXXXXXXXXXXXXXXXXXXXXXXXXXXXXXXXXXXXXXXXXXXXXXXXXXXXXXXXXXXXXXXXXXXXXXX
