--------------------------------------------------------------------------------------------------------------------------------------------------------------------------------------------------------
--M-E-BB---M?M--?-XoB----o-o-o-E---X?o--BoB---M-?o---MXEBE-----o---X-EEXB-B----M--M-?oMM?M?-XoEB-XE-----EEo----X--M--M-----E-oX--B-----MoEMM-M-?-BMMB?o-M-o--EB---?-oo---EX---?X--??M-MX-M-----E-o---?--
------|B--EBB|---------X-----|B-MB-o-T---oEM--E-M---EM-XET-MM-X-XB---E--T?|-E---o-?EE?---??-B--X-|EB-----XE-o--Mo-MB-M--?XM?-EoMo--X?-o|EXE?-?-X-XooE-|-Bo-E---o-?X-oM--X-MoooBEoXE?M-o-----M-o-E--X?---
-MXo--X|oX-EX-?o?E---BME-X?E-oMoXo----BXBT-o-E|--M--E-E?-M-|E-E--TME---XM--?-E-ME-EXXB-M-|oBB--|oE---oEB-B?oMEoEM?o-?ToB-B---T---M--?E-oo-B-oo---X?----oEE-EooB--M---o-B?----E---B--o--M---??M-?-E---Xo-
-M-|M--Eo-??X-oX?-o---?---TX-o|M-BMEBBMMM---o-o-M-X-B--?-E--E-?M---X?M-M?X-oMoMXMo--|B-BEMX--M-??X-?X-MME-?-M?-M-X-M-o-|-EB---X-?----TM-|M?-X--?oX------?E--B?B?-MX-BB--EBMB-o-?MoX??M-EM--?M-X-E--?oBX-
---BX---oooM-E-o-oMMo-o?--o-?M-----|---M?-o-E-XB----?X--MoM-E--X-----X??EM-B|o?-BEo??-?oXE?-BBoTTT-X?-M-B-TBX-oE-BX---Eo--TB?--MXEEMB---X-BM--oEM---EXE----?-o-o-EEB?-B--BoBEBo-----TM--MBE-ooXM?-oM----
-o-o--BEoEoTM|EooBT-oBo|--T-B--MB--Mo----X|-X-T---E-TT--o?X-|-MB-E---M-EB-E?MX--|?oM|---MB--BMX-B-----MEB?EM-E-o-T--B-B?Xo--o?M--X-XM--?M-TBM?-Eo--o-X------XM--E|Eo-?B??T--?-o-----?-E-E-X-BT-?-?---XX-
-M-?MBo|----o-M-BE-?--E---|M|-E--B--o-M----o--?-----o-BXMM??--ToE-BB-Bo-XE-B-EMBB-?|E-BM-X-----MoEE-----?oMoM?-M-EM-o-XXMTo-Xo?--?--|--|-------oEB-BM?-X-X--o-MoBo-MB?-E?-X--MBB---o----E?E?XT-??--MX-Bv
-T-o?XM-o?B-?--?|-o--XoE------BE?--M?-M-E--X-EX?--?-X-o-EB-?-X--Mo-T?TB-BB-XM--?|-E?TMXB-B---X---ooo--MoME-?---B-o------?M?-M|ooo-?---MB-B--?XM-B--X|oEoo----M-ETM--?E?B?oB?-BEX--EB-Xo-o-X-XT-X|o--EEEf
---Eoo?--------M-X-XBX--?-o---M-MB--E?M-----E--T----oB--X-?X-E-E-E-M--B?BX-o-MME---BTE--BB----?--MB---M---??BM-E---MB-------?BX-EEXX--E-X-XEM-|--EX-?XMM-o??-o?TT--B|o-T--E|-T--ooMo---MXXM-?XX?XoM-M--f
-o-B--X---XXo---B|--EEB-|oTB-E-oMBM?o-------|X----X--|E?o?----E-MX--B-M---BBM---M--E-|-E-------MX-?M?-|oo-BXEBME-B-BM--MB-E-BMBBoXo?XE--oX-|EMM--BBoMB-?-E|Xooo|E--E-Bo--XMMX-B--T-E--E-?BB-X-----M---Bf
--ETXMBBMEE-X-o-?---X|?-M--XoE-X|-o-EB-?--Mo-M-XoMooBTB-Eoo-?-B?BMEX-Eooo--T-B-B-----?-TX-MM-E?oTE--|?-E--MEMX---?-XX--TT-X--E?MBXE-|oEX-|XB?B--E-EMXT-o---oB-----o-X-?--BXB|----B-----oT--Eo--EB-XE-o-f
-XME----o|-----MTEo-|o--EE?M-X--MMM-EE-oM----o---Boo---o?-MX--X|BoXT--BM-X--M-o---B-------|E--MMoX-BME-B-EX-M-X?B---------M---M-----?E?----?XE-??-|-oMX---X-M-X-o-X-X-ToMTo-o-EoB--M---oMX--?--EB-M-BB?f
-?MEoM---E?-B-?--|TMM?E-XT|?-XX--?--?-BX|-o---?-M--X--XXo-?-o-MXo-M|o--M-EM-BMBEB---EXo???BoB--EEX-o?XM-B|XB---|-B---?----?B--o------B|-M--o-MXo---?||-EXXTX|XX---BM--?-TX-oXooo?-------E---TMETM--?-oBf
m-X---?B--BB-B?o-XE|E---B-oT?oT-M-oo|-MMXM---o|-----o-M-----|--o-M-X--Bo-?o---o-MXB--X?XE-oEE-ME-----X--M-|E----E|E-XToE--E-EMX----Mo-----X--?Xo---TM?XMX-E-M-?---|-o-T-----?---?M-----ETBM-X-?|EX-TX|MX
XXXXXXXXXXXXXXXXXXXXXXXXXXXXXXXXXXXXXXXXXXXXXXXXXXXXXXXXXXXXXXXXXXXXXXXXXXXXXXXXXXXXXXXXXXXXXXXXXXXXXXXXXXXXXXXXXXXXXXXXXXXXXXXXXXXXXXXXXXXXXXXXXXXXXXXXXXXXXXXXXXXXXXXXXXXXXXXXXXXXXXXXXXXXXXXXXXXXXXXX
