--------------------------------------------------------------------------------------------------------------------------------------------------------------------------------------------------------
-?-EM--EB----M--o--BBX--XB--M---?--M--E?o-EBBoo-XM---o-B--B----Mo?-?-B?-BE-XM-E??BB--M-B-----?---M-E-M-?BB-B-XMBoX?---E----BM----E----BX-B-B--?EXXB-E-ME--XM?M-?-B?--oBE--B---B-EB?-?B---EB-MM---oBX-EB-
-BM-----o?---M-o?X-?o--XM-?-M---------|??o-M---EXXBXE-EoXE-X?-EM-oMBX-E---o--B??oT--E-?-M-?-?TE?BM?o-EM-E-----BMEX?o---o--M-M---oB--o-XB-BBX----MB?-|E--Bo-EMEM--?-B-o-|B--EEE-B-B|BX--ME?X?-?---E---Mo-
-M-o--B--X--B---B?-M---E-Eoo----?--XE--M-M-o-Xo--MX-Eo?---?TEMX-Bo|o-?--X---XE-o-TEoBBEM-oMEXM-EMBE---X-B-o--B-To-BE----Xo--|----X-E-EBT-|EBo---?X--Xo--XM?-EE-?-M-M-XE--MX?X--BXo-T-o-----?M??o-B-oBME-
-E?Eo--?---EM-B----B-?EMBMEM?ME-oX?oEX-B--?-M-XM-|XM-XMooMo-BMB-?XM-BXX-BMM?EoMM--?---Xo--MMT---o-T-oE-oMXEoEBEM--MoX-?-MBB---M---XB-MB--??----MXX--T-M-M||---M----?E|B-X-T-?-MBM---?-MEX----BB|-E-MTT?-
------B-X-?EE--Eo-?BMMTXMMo-o---EEo??o?X-B-BT?-MoM?-?|T?MT-?M---B-X-|X--B-|M|X-|Mo?MM-?-E--o--M?--?B|M-E-TXE-o?B-MX-?X--B|-?o--M?M------o----?o-XXM--Xo--M-MX-E?B?-X----B?X?-BT--M-M--X|-?---T-M-MB-----
--BEBMoM-B-||M-?--B-XT-B-|M--?--X|?B-MXB-M-T----M|TBET-B-BXoo---|-M?TB-?-oo?BX--MTB-oX-XMX?M-XT--BT-M-X-B--M--Xo-TT-o|--oE---o-??----BXBM?---X?ET---oo----o---oM--XB--E--B--MM--MT-?---?-M----E-o--B----
-?-Xo?-E-o-XXo-?-oMXX--T-EoM-M---XX|oEXM-BX|o--o---M--ET-BBMo-E-?E-XBBo-XX-o--Mo-BB-X---oT?EM-M--B-BX-XX---|-MXB-----XMM--MME--E---XEXB|XoB--|Mo--o---?o----XM---Mo-X-oEE-M-|-o--?oo?-BX---XE-T?M-BBB-Bv
-?M---X--M-E-o-EM?TMT-E?B?EXo|o--??X-TX?oB-?Eo-?oE-o--XooE-|X??-X--------M---o|---M-o--o---?M-EoEX?TB--?M-?-EB-B-B-----MBET---??o?M--|M--Mo--Bo-Xo?-XXT-X?--E-B--X?--?--?-E----?--o--o---?B-XM-X-?-----f
--EX?XT------XE-MET-o-XMX----X?-XMEoEB-o?X-|-----EME--|X|?--Xo-?-E--EX-M-B---M-----X---X--E-B--o-M--M--M--??-M-EoM?---?|---?MX-TM-?--B---oB-E|T--XoEEooMXX-MB--XE-X-?-Bo---X??MT-X-Mo-Eo-?---T---E-Bo--f
----X--B-Xo--|--T-B-oE??---B--|-E----o--E--oME-B-X?oBM?|-oE---?o-Mo-E??-X|?MB-X-B-o---X--?-o?-BTM----?-M-X---B--?-TM-BETM--XEB-B?EBX?-Eo-o--o--MMX?-T--X?EEXX--|X?Mo-oT-X-?-M---B?EXE--o---MooEX-EM--E-f
----oXEEMT--oT?-o-|-MTB-E--o-M?------MMBB--MoMMM--M-oX-T?|-?X-EXMoEE-X-Mo-BB--Xo-EBo-o---ME?T--ME-?XX--X-Mo--MB--B-oB--o|X-|-E---E--To-B?|--EMBEEBoE-M-XTB-o|X--MB-|X--BT-?----o-B|E-E?-M-X-----B|X-B-Ef
-E-o-o-----o--T-BBo-TM---E-MEo---EM-BXMT-----E-E-?E--BMoTX-EE-----B----M-X-oE--M-o-TB--X--|E-B-EMEBB-o-MXEB---?--oE--??B-o--o-E--MB-X--MXX-?--o-|MXo-XEX|E---M---X--?o-T-oX-?-X|XT-|-oE-Xo|----?--|-TM-f
--B-o-M-X-B-B-XE-|B--?EE-B-E|---XToB?-??EM-?o-X?M--E--XMM|-?--?------E??-M--B-B-E?M-M-E?XMX-M|BE--BB-EEo------T-M-T--Xo----BB-Xo-B-oB?B---X-----?T---ToBB?-BoXM--X--E-o--X?oBMXM-o-T-EB-E?-MEB-X-o---T?f
m--ME--BBoX--??--E---M-T---EBB??-?M-TX|-To--T-EEEBEB-EoTT?----B-?BB-EEBo?EM----?---M--X--TBEB--o--TMMM-oB?o-BE-?-----Xo-XB-BT-o---EXE|-?E?TBXB-o|M?-ETTXTM-X?-|?-?-XEo-BB---||TE--B------B-MB---EEoooEBX
XXXXXXXXXXXXXXXXXXXXXXXXXXXXXXXXXXXXXXXXXXXXXXXXXXXXXXXXXXXXXXXXXXXXXXXXXXXXXXXXXXXXXXXXXXXXXXXXXXXXXXXXXXXXXXXXXXXXXXXXXXXXXXXXXXXXXXXXXXXXXXXXXXXXXXXXXXXXXXXXXXXXXXXXXXXXXXXXXXXXXXXXXXXXXXXXXXXXXXXX
