oE|ET-|o?MXo?XToM??|XXEM-MEM-oBTBE|oo-MXT?o??MXXB|EB?X-||MBMXoMMTTBM|X|-EBEMTMTBT|BTTMBT?XBXX?B--BTET|EBB--MTB|o?M---|TBBo?-|X|?T-?o--EM|-XXTB|-BTXMM-M-TT?|X-??EE?XX|BETEoT?-T?-E|EBoTMMTEEo|XXXo?oX-Bo
X-M|M-?---Xo--E--X-o-----BB--|--EX-------T--M-------M---?-Xo-oBo?XTE-oT?|----X?----BB-E-|--B--EB----Mo?--?oB--X---M--X--X?E---X-E?-----o--X---?-E--?--?----X------??-X?EEMB---X-EM-M--------B--BX-Eo---M
EBM-ME-?B-o--E-X---X--X-----BB--o----B------MEX-X-M--XE?E--B-----M-----?---?o--B-o--??---o------E?---X---X-oE---M----?---B-o--M---E-----oME-X-----------------?-----BBM-M-B---o---X--EX-----MB---E---o?-
|--?B-B--XE?--BE?BEo?--E-----?X-----X?M------oB------oM-----oB--M-B--o-------??-BBB--o---B?-?-E--E---M-E-?---M?--oB-BoBMX--B---E-------?oE--oMX-E---EB-EE----E--o--MB---BBM--o----o----o---------E-BM--T
M-MM-B-M-oX--X---??ME-Bo-?--Xo-o-?X----M?oB--M-M--ME-?--?----E?--oM-------oB---X-M-X-o?---E-E----X-?----E--o?-----?--M-----X-M-X-----?------E---BB--EE---M-E-M-----B--?-M----X----------EEM----o--MB-M-?
M----X-----XX?BBE-MM?-o-Bo---?---oX---?-o?X-??B--Bo--------?-MM-M?B?---Mo-M--------X--X------B-o--?MoE--E-M---?-----------?----o-?-------M----EXo--EE-M-------E----M---XMo---?-oo-BM-E----M-------X---EM
TX--X--M?BXoB----X---o----E--E-B-?--?-----B-?---X--?-EBE-o------o--E--B-B-?------M-Bo---E--XX---M--MEo-o?-EMX----XM---M---B----?----BX?------MEM---X-M--X---o--M-M-E--------X----------o----M------B-M-X
T-?-BB-MXE----M-X-?--B---------?-B-Eo----B-MX?M--o?-E-B----oB---?Mo----XM---B-XE-M-X-------?XXBBoXE-M----X--o-BM?---EM-?----X-?--EXM---?----o-----MBo--X-?E-------------?------BXME--?--BB-----E---E---v
?-E-?-B-o?EB-B-E--------M-------o----?-B-B-M-?---EX-----M-----B--B--Mo----?-o---B----B------o-o-?X---BMEE----E?-B---Mo-----M-M-?--E---M---o-?-o--EB-X--E---M-MM---E--X-?-?-------M-----MMXB---o---B----|
T-oo----EBX-E-XEo-M---E-------------EE-----X-EBB--?--??-------------X-o?M-B-------M-------BX--M------XEE?B---X----o---------M---Eo-X-o----------o------?-B-X-X----?----?-B------M-B-?------B--E---EoX-ET
M----X---o-BBEE-----o-?-oB-?---B---M-Bo----X-?-MMX-?--X?---B-oX-B?---X---------E---o--o--E----BX?X--MM--B---o-EB----o-----?-E---MMB-M--------BM------M------oo-BBEX-?---X--B-----o----o--?o-B--?-BBo--Xo
E-o-----B-B-?-M----EMX-----?--E-?-X--?-----MX?-X?---B-X-XB--o?-E----BM------X--X-X-X-?---B---M-o--------o?---o-M?o-oMEE----o-o-XB-----?-----E--o--M-o-?---Mo-X?-B-MEX-EM----X---Eo--?-?M-----M--B--X---T
E--E----XEM--E--oB--X--o----o---B-B--E-----------X--------X-M-o-----?TM-o-----M---?-B-----M-E--B-------M----EBM-------XE--E-M-X?---ME----E--B--?MX-----o---B--EB---B----?---X?--o-?----EB--EX---?----M-T
X----M----X---o--|-XX-ME-----B--?-?--o----XooX-E--?B?---B--???ooB--EE-o----XM-Boo?MBMXE----E--BB-?--?X-B-M---?-----X-M--o-BE----oX--o----E-M?EB-o-o-X--E--BB?-B-B??---EX---?--MX--------X--Eo-?-E-------
m-----o--------?-------?MB?X-B--X-?-------MB--B-o--BXBB-B?XBM-----o--M-E?-X-------E-B-E----MB-o-B------o-oM----M---X--?---oX---------o---M--B------?--?--o?-o--B-B--X-B-M----------M----X?M-X-M?M?------
XXXXXXXXXXXXXXXXXXXXXXXXXXXXXXXXXXXXXXXXXXXXXXXXXXXXXXXXXXXXXXXXXXXXXXXXXXXXXXXXXXXXXXXXXXXXXXXXXXXXXXXXXXXXXXXXXXXXXXXXXXXXXXXXXXXXXXXXXXXXXXXXXXXXXXXXXXXXXXXXXXXXXXXXXXXXXXXXXXXXXXXXXXXXXXXXXXXXXXXX
