------------------------?------------------------------------------------------------------------------------------------------------------------------------------------------o----------o----?--------
---?--------------------------------------------------------o--------------------------------------------------XX-----------------------X---------------------------------------o-----------------------
------------------------------------------B---------------------------------B---------------------------------XXXXXXXX--------------BBBB------------------------------------B-----?---------------------
----------------------------------------------------------------------------------------------------------------------------------------------------------XXX-------------------------------------------
--------------------------??????---------------------------------------o-------------------------------------------------------------------------------------------------------------------------XXXXXX-
-----------------------------B------------o-------------------------------------------------------M--------------------------------------------????------------------------------------------M----------
---------------------------M----------------------------------------------------------------------------------------------------------------------------------B--------------BBBBoBB---o------------BBB-
--------------o-----------X------------------------------------------M----------------------------------------------------------------------------------------------------o----------------------------v
--------------------------XX---------------------------------------------------------------------------------------------------------------------------------------------------------------------M-????f
--------------------------XXX---------------------------------------------------------------------------------------------------?----------------------------------------------------------------------f
--------------------------XXXX----------------------------------------------------------------------------------------------o--------------------------------------------------------------------------f
-------------------------TXXXXX-----------------------------------------------------------------------------------------------------------------------------------------------------------------T--????f
-------------------------|XXXXXX-------------------------------------------------------------------------------------BB-------X------------?---------------------------X----------?-------------|------f
-------------------------|XXXXXXX---------------------------------------------------------------------------------------------XX----o---------------------------------XX--------o---------------|----TTf
m--------Eo------EX------|XXXXXXXX-------------EE----------------E-----?------------------------E-----------------------E-E?X?XXX?-------------------E-----E---------XXX--------------EEB--E---E|-??M||X
XXXXXXXXXXXXXXXXXXXXXXXXX|XXXXXXXXXX--------XXXXXXXXXXXXXXXXXX-XXXXXXX-XX------XXXXXXXXXXXXXXXXXXXXXXXXXXXXXXXXX--XXXXXXXXXXXXXXXXXXXX-XXXXXXXXXXXXXXXXXXXXXXXXXXXX-XXXXXXXXXXXXXXXXXXXXXXXXXXXX|----||X
