-----------------------------------------------------------------------------------------------------------------------------------------------------------------------B--------------------------------
--------------------------------------------------------------------------------------------------------------------M----B---------------????XXXXX------------------------------------------------------
----------------------------------------------------------------------------------------------------------------------------------------------X---------------------------------------------------------
--------------------------------------------------------------------------------------------------------------------------------------------------------------------------------------------------------
----------------------------------------------------------------------------------------------------------------------------X--------------------o---------------?--------------------------------------
------------------------------------------------------------------------------------------------------------------------------------------------M-----------------------X------?------------------------
------------------------------------------------M-----------------------------------------------------------------?---------BBBBBBB---------------------------------------------------------------------
------------------------M------------------------------------------------------------------------------------------------------------------------------------------------------------------------------v
-----------------------------------M-------------------------------------------------------------------------------------------------------------------------------------------------------------------f
----------------------------------------------------------------------------------------------------------------------------------X----X------------------------------------o--------------------------f
-------------------------------BBBBBBBB---------------------------------------------------------------M----X---BBBB-----?????----------XX--------------------------------------------------------------f
-----------------------------------------TM---------------------------------------------------------------X------------------XXX-------XXX---------------o-----------------------?-------T-------------f
-----------------------------------------|--------------------------------------------------------------B-XX---------------------------XXXX--------------------------------------------T-|-------------f
-------T---------------------------------|----------------------------------------------------------------XXX-----T-----------??T?????-XXXXX-----------?-------------------------------|-|-------------f
m------|-------E---------------E-------X-|----------------------------------------------------------------XXXX-E-E|---E-E---E---|-E----XXXXXX------E-----E--------------EE-E----------E|-|---?----E---EX
XXXXXX?|XX-----X-XXX-XXXXXX--X---XXXXXXXX|XXXXXXXXXXXXXXXXXXXXXXXXXXXXXXXXXXXXXXXXXXXXXXXXXXXXXXXXXXXXXXX-XXXXXXXX|X-XXXoo-XXXXX|XXXXXXXXXXXXX------XXXXXXXXXXXXXXXXXX-XXXXXX--------XX|X|XXXXXX-------X
