---B----------------------------------------------------------------------B-----------------------------------------------------------------------------------------------------------------------------
------------------------------B--------------------------------------o-------o---------o------B------------B--------------------------------------------------------------------------------------------
------------------------------------------------B--------------------------------------------------------------------------------------------------------------------------------------------B----------
--------------------------------------B-------------------------------------------------------------------B---------------------------------------------------------------------------------------------
----B--------------------------B-------------------B-------------------------------------BB-B-------------B---------------------------------------------------------------------------------B-----------
-------------------------------------B----------------------------------------------------B---------B----B-------B-------------------------B---------------------------------------B--------------------
-------------------------------------------------------------------------------B--o--------------------------------------------B-------B----------B-----------------------------------------------------
--B-----------------------------B-----------------------------B------------------------o---------B-------------------------------------------------------------------------------B--o------------------v
--------------------------------B----------------o---------o------------------------------------o--------------------------------------------------B---------------------B-----------B-----------------f
------------------------------------------------------------------B-B-----------o--------------------------------------------------------------------------------------------------------------------B-f
-------------B-----B------------------------------------------------------B---------------B------------B------------------------------------BB--------------------B------------------------------B-----f
---------------------------------B-T-----T--oE-----------B--o--------------T----------------------------------T-------------------------------------------B-------------------------B------------------f
-----------T-----------------------|-----|---T----T-----B------------------|----------T-----------------------|------------------T------T--------------------T--B--------------------------------------f
-----------|------B----------------|-----|---|B---|------X-----------T--T--|------o---|---T--------------T----|---------------B--|------|---------T----------|-------------o---------------------------f
m-----B----|--------T---T---T---E--|-----|---|--E-|--T-------E-------|--|--|----------|---|---T------T---|----|-----------T------|------|-----X---|---T------|---T---BB--------------T----------T------X
XXXXXXXXXXXXXXXXXXXXXXXXXXXXXXXXXXXXXXXXXXXXXXXXXXXXXXXXXXXXXXXXXXXXXXXXXXXXXXXXXXXXXXXXXXXXXXXXXXXXXXXXXXXXXXXXXXXXXXXXXXXXXXXXXXXXXXXXXXXXXXXXXXXXXXXXXXXXXXXXXXXXXXXXXXXXXXXXXXXXXXXXXXXXXXXXXXXXXXXX
