--------------------------------------------------------------------------------------------------------------------------------------------------------------------------------------------------------
------------------------------------------------------------------------------------------------------------------XX------------------------------------------------------------------------------------
--------------------------------------------------------------------------------------------------------------------------------------------------------------------------------------------------------
----------------------------------------------------------------------------------------------------------------------------------------X---------------------------------------------------------------
--------------------------------------------------------------------------------o----------------B--------------?-----X---------------------------------------------------------------------------------
-------------------------------o------------------------------------------------------------------------------?------XX---------------------------------------------------------------------------------
-------------------------------------------------------------------------------------XXXX---------------------------XXX-------------------------------------------------------------------------o-------
----------------------------------------------------------------------------------------------X--------------------XXXX--------------------------------------------------------------------------------v
---------------------------------------------------------------------------------------------XXB------------------XXXXX--------------------------------------------------------------------------------f
-----------------------------o--------------------------------------------------------------XXX------------------XXXXXX--------------------------------------------------------------------------------f
-------------------------------------------------------------------------------------------XXXX-----------------XXXXXXX--------------------------------------------------------------------------------f
--------------------------------------------------------------XXXXXX----------------------XXXXXXXXXX-----------XXXXXXXX--------------------------------------------------------------------------------f
-----------------------------------------------------------------------------------------XXXXXX---------------XXXXXXXXXB-------------------------------------------------------------------------------f
----------------------------------------------------------------------------------------XXXXXXX-------T------XXXXXXXXXX--------------------------------------------------------------------------------f
m------------------------------E-----------E------------EM----------------------E---X--XXXXXXXX-------|-E---XXXXXXXXXXX----???????----------------------------------------------------E----------------X
XXXXXXXXXXXXXXXXXXXXXXXXXXXXXXXXXXXXXXXXXXXXXXXXXXXXXXXXXXXXXXXXXXXXXXXXXXXXXXXXXXXXXXXXXXXXXXXXXXXXXX|XXXXXXXXXXXXXXXXXXXXXXXXXXXXXXXXXXXXX-XXXXXXXXXXXXXXXXXXXXXXXXXXXXXXXXXXXXXXXXXXXXXXXXXXXXXXXXXXX
