--------------------------------------------BBBBBBBB-----------M------------BB--------?------------B---------------o----X---o--------------------??????----------BBBBB----------------------------------
--------------------------------------------------------------------------------?????------------------------------BB----??-----------------------------------------------------------------------------
--------------------------------------------------------------------------------------?-----------?---------------------------B------XX--------------BXXXX---------------------------------o------------
-----------------------B--------o------------------XXXXXXX---------X------------------------X-----------------????---?-------------------------BBBBB---o------------------------------------------------
------------------------------------------------------------------X-------------------------------------B-------------o----------o---------------------X------------------------------------------------
----------------------------------------------------------------------------o--------------------?---????????--------------o-oBBM----B------------------------------------------------------------------
----------------------------------------------------------------------------------------------------------------o------oM------XX----B?BBBB-------------------------------------------------------------
----------------------------------------BBBBBBBB----------------------BBBBB--?-X-----X---------------------------------------oX-----------------X------------o-----------------------------------------v
-------------------------------------------------------------------------------------------------------------X---B-----o-----?-----X----------BXXBBBBB-------------------------------------------------f
------------------------------------------------------------------------------------------B--------------B----------------------B-------------XXXXX----X-----------------------------------------------f
-----------------------------------------------X-----------------------------------------------------------------------------o---BM----------XXXX---?-o---------X---------------------------------?----f
------------------------------------------o---XX-------------------------------------------T---------TT-X------------X-----o----X-----?-----XXXXX-------------X----BB----------------------------------f
---------------------T--------?--------------XXX----------------T---------BBBBXB-o---------|-o-------||-XX-----BBBBBXX---T----------XXXX---XXXXXX???-BX-------XX-T-------------------------------------f
---------------------|--???????---------XXXXXXXX-------------?--|---------------?----------|---------||-XXX--------XXX???|?---------------XXTXXXX-------------XXX|-------T-------------T---------------f
m--------------------|------E---E-----E----XXXXX------E---------|------------E-----------Eo|M----E---||XXXXXE-----XXXX---|--E----EE----M-XXX|XXXX---------E--MXXX|-------|----------E--|B--------------X
XXXXXXXXXXXXXXXXXXXXX|X----XXXXXXXXXXXXXXXXXXXXX------XXXXX----X|XXXXXXXXX--?------XXXXXXXX|XXXXXX---||XXXXXX--BBXXXXXX--|----X---------XXXX|XXXXXXXXXX-XXX---XXX|XXXXXXX|XXXXXXXXXXXXX|XXXXXXXXXXXXXXXX
