--------------------------------------------------------------------------------------------------------------------------------------B-----------------------------------------------------------------
------------------------o-------------B------o--------------------B------------------------------------------------------------------------B---------B---------------------------------------------o----
-------------o-----------------------------------o-----------------------B--------------------o-------------------------------------------------------------------------------o-------------------------
------------------------------------------------------------B--B----------------------------------------------------------------------B--------------------------------------B-----------B--------------
-B-------------------------------------------------------------------B-------------------------------B----------------------------------------------------------------------------------------B---------
---------------------------------------------B------------------------------B---------------------------B---------------------------------------------------------------------------B-------------------
-----------------------------------B---------------o---------------------B-------------------------------------------------------------------------B----------------------------------------------------
----------B---------------------------B----------------------------------------------------B---B--B----B--------------------------------------------------------B--------------------------------------v
-----------------------------------------------------------------------------------------------------------------------------------------------------------------------------------------------------o-f
--------------------------------------------B---------------B-------------------B--------------------------------------------------------------------------------------------------------------------B-f
--------B----------------------------------------------------------------------------B--------------------------------------------------------B----B---------------------------------------?--------o--f
---------------------B-----T------------------------B--T-------------------------------------------o-----T-----T-------B--------B-----------------------B------T-------------------B-------------------f
---------------------------|----------T----------------|-----B-------------T-B--------T------------------|?----|-----------------------------BB---------------B|-----------B---------------------------f
-------T-------------------|---X------|----------------|-------------------|----------|------------------|-----|-------------------------------T---------------|-B-------------------------------------f
m------|-------------------|----------|---------B------|-------------------|----------|------X-----------|-----|-------------------------------|---------------|---------------------------X-----------X
XXXXXXXXXXXXXXXXXXXXXXXXXXXXXXXXXXXXXXXXXXXXXXXXXXXXXXXXXXXXXXXXXXXXXXXXXXXXXXXXXXXXXXXXXXXXXXXXXXXXXXXXXXXXXXXXXXXXXXXXXXXXXXXXXXXXXXXXXXXXXXXXXXXXXXXXXXXXXXXXXXXXXXXXXXXXXXXXXXXXXXXXXXXXXXXXXXXXXXXX
