--------------------------------------------------------------------------------------------------------------------------------------------------------------------------------------------------------
-?--EEo---o-B?M------oEBEM?----XXX-----------------o----oE-Mo-------M-----M-E-M-----Eo--X------??-XE--E--o----M-E--oMoB--BM--?o-XMo---------?--?E?o-?B-B-----------M-Eo--o-BMM---M--XoM--o---M-M-E-XXX--
-XM-MoEoBMMM-BoME-------?B--B--E---XM-o?B--B-oMo--M--M-Xo?---?M----X-o------X?---B--MM----M-E?B-E--?-EBE--o-B--o?B--X-------X----oE-E?B--o-E--o-----BE-M--??-MX-B--XMo---B?E-?M?--oE-?-o-------B--M-o---
-X-BM---M------E-------o-BEBo--o-E--o-E----X?----B---------M--?o?-M---B--?X---MX?---MBXM----E--E-o-M-B-B-----oB-----o-----?M----E---o-E-MBoo--M--EE--?-M---------BoX-?---M------o--M-XXEE---E---E----M--
-B-?----B-oMo-----oB-E--EXX--X-----X--M-M--M---M-M-B-?-ooMXMM-Mo?--BB--E--o-oo-EE---o------------M?-M--M-X--------------EB?-M-B-EM-----MEM-M-------E?-----o--MMM---B-MXM-MX-------oo--E----B----X-------
-oE-X---ME----M--o---XBMM-E-o-E-X----X-X-BXE----M--MBB--E?-E-?--?----M-?o--B---E--BoX--oo-E-B----E-o-X--E--MBo-X------M-o--E-?M-E--Eo-MM-M--XX---o-----?X-E---E--X-----o--M--M-MXo----EE---MEoE---------
--?-M---E-MXB---B---B?-------XM?----XM?--?E-?oBME---M??--o--B?----E-oo-MXX--o------------?----X-o--E-Xo-?XME--EM--o---B--?BXX---o-??-Bo?B----E-XEB-oX----Bo--X---X-?-oE-o----EM---?MB--?---EB-E---X-XM--
--BMEB--BE--E?-?XB---------E-E--B---??o?EE---o------M--BB--X-X?EB-----o----?M----oE---E-B----B--o?-E-----?--oo--X-o--Xo-----B--M-?---E-XE----BM---Xo-MM---M-MBM-M--MXE-MoXE-o-X---EM-E?--oo-MX?oEB-M-M-v
---oM-X-----oME---EEo-Bo------?---M--ME-M------B--E-E----MoM--o--M-------?---X--------X-M---E-E-M-?---B-E--E---B--o--M-?----?--M-?-M-B-----Eo-----BX-XM--E-MMoBoEX-M-o?M-E-------E-E--X-----MB--E-----?f
--B--o--?--E?E--------MM-o-o-XoBoB-?EoM-X--MM------E-B-------ME--BB-M-----E--o-E-------X--X----B----?-M-?-M?-M--?-X----M-M--o--B--E-XB--E-M?--?--M?-X----X?E-B--M-------E--E------BM---?-MMMo----X-B-MXf
----BXo-----B-oE--?---X-----MME-------------Eo--EoEXM----o--o-?E----XE--B--X--M---?-MB?-----oooBB-M---E--B-----E-?--o--EE-?-M--o-M--?-oMo-o--?-------B--BB---M?B---o-X--B---X------X-??M------X-B--M--Xf
----Mo---o-----BE---o-ME-?o--BE-MM-?--M----E-B--E-E---X-ME-E-o-M---?-----EX-XBMMMM-----XM-??---E--E-?--MoX--B-o--Eoo------------B------EB-Mo-E----E-----EE-XoEXE-BoM-M-X---EMX-Mo-M--M-X?o-B--??-----M?f
---M?--EMo?X--MEMX------E---?---M---X---?--BMoo----o-B--M--oE-E-?-oMEXEMEME---X-EB----E-o---oB-X-X-E-M-B-oo--EB-M-MMB---X-E-o-XXE--E-M?M---o-----E----------MEB-?--E-X--o----o--oB-----EM------M--X---?f
-?-?----B------o-??M-oMB--o-M----E-X-E-------M?--E---?--?--E--M-?--EE-B?---XX-E-------M--MM---o--------EEBo--EMM---?o-MXB----o--M-?--XX---XB--?MoE--------X-ME--B---o-MM-o--B----?--?-X---XB-X-MMMM--E?f
m-EBBE-MMXX-MM-?X-?M--?-?---X?-?-oM--?-----?M-B--X---XM-E?-----B?--BXo--M-----?-o-?M---X?-M---M-B--B---X--------o?-ME--E-?-E-M--?X--------X---B-Mo?MoE-B------E-Bo--E-?-X-BM-X-o-X----BMB----B-X----E-BX
XXXXXXXXXXXXXXXXXXXXXXXXXXXXXXXXXXXXXXXXXXXXXXXXXXXXXXXXXXXXXXXXXXXXXXXXXXXXXXXXXXXXXXXXXXXXXXXXXXXXXXXXXXXXXXXXXXXXXXXXXXXXXXXXXXXXXXXXXXXXXXXXXXXXXXXXXXXXXXXXXXXXXXXXXXXXXXXXXXXXXXXXXXXXXXXXXXXXXXXX
