-------------X-o---------------------------------------------------------o---------------------XXXMXX------------------------o--------------------------------------------------------------------------
------------BB?????----BBBBBB------------------------------------------------------------------------------------------?--------------------------------M-----------------------------------------------
----------BMBBBB-------------------------------------------------------------------------------------------------------------------------------------------------------------????????-------------------
------BBBBBBB--------X-o-??????M?----------------M---------------------------------------------------------------------------------------------------------------M--------------------------------------
------------o--Xo------------------------------------------------------------------------------B--------------------------------------------------------------------------------------------------------
----------------------------------------------------------------------------------------------------------------------BBBBBBBB--------------------------------------------------------------------------
-------------------XB----------------------------------------------------------------------------???????---------------BBBBBBB---oX-----------------X---------o-----------------------------------------
-----------X---?X?-----X---------------------------------------------------------------------------------------------------------XX----------------XX--------------------------------------------------v
----------------?-----XX---X--------XXXX-----------------------------------------------------X----------------------------------XXX----------o----XXX--------------------------------------------------f
-------------B-----X-XXX-------------------------?-----------------------------------------------------------------------------XXXX--------------XXXX--------------------------------------------------f
----------B---------XXXX----------o---------------------------------------------------------------------------------------M---XXXXX-------?---M-XXXXX----------------------------XX--------------------f
---T--------B------XXXXX---o-----------------------------------------------------------------------o--T----------------------XXXXXX------B--?--XXXXXX---------------------X----------------------------f
---|-?o--------?--XXXXXX------------------------------------------------------------------------------|-----------????????-BXXXXXXX-----------XXXXXXX???-----------------------------------------------f
---|------------TXXXXXXX--o----T------------------------------------------------X---------------------|--------------------XXXXXXXX----------XXXXXXXX--------------------------------------------------f
m--|-BE--?X----E|XXXXXXX----X--|-----------------------------------------------------------------E----|--------E-E?E?????EXXXXXXXXX-X-------XXXXXXXXX--------------------------XX----------------------X
XXX|XXXXXXoBBB-X|XXXXXXX------X|XXXXXXXXXXXXXXXXXXXXXXXXXXXXXXXXXX---XXXXXXXXXXXXXXXXXXXXXXXMXMXXXXXX-|------XoXX-XXXXXXXXXXXXXXXXXXXXXXX--XXXXXXXXXX-XXX--------XXXXXXXXXXXXXXX-----XXXXXXXXXXXXXXX---X
