--------------------------------B------------------------------------------------------------------------------------------B---------------------------B----------------------------B-------------------
--------------------------------------------B------------------------------B-----------------------------------------------------------B------------------------------------------B------o--------------
-------------------------------------------------------------------------------------B------------------------B-----------------------------------------------------------------------------------------
------------------------------------------------------------------B-----------------------------------------------------------B-----------------------------------------o-------------B-----------------
--o---------------------------------------------------------------------------------------------------B--------------------------------------------------------------B----------------------------------
----------------------------------------------B--------B--------------B---------------B------------------------------------------------------------------B----------------------------------------------
-------B--------------------------B----------------------------------------------B-----------B----------------------B-----------------------------------------------------B-----------------------------
---------------------------------------------B------------B-------------------------------------------------------------------B-B----------------------------B-----------------------------------------v
--------------------------------------------------------------------------------------------------------B--B---------------------------------------------------------B---------------------------------f
---------------------------o-------------------------------B----------------?-------------------------------B----B-------------------------------------------------------------------------------------f
----------------------------------------B----------------------------------B------------------------------------B?-------------------------------B-----------o--B--------------------------------------f
------B---T--B-----T-------T-------------------o-----------?--T---------T---T--T----------------------------------------------T-----------T------------T---------------------o-------------------------f
----------|--------|---B---|----------B------------------T----|---------|---|--|-----B---T------------------------------B-----|-----T-----|------------|----------------------------------------------Mf
----------|--X-----|--T----|-----------T-----------X-----|----|---------|---|--|---------|--------T---------------------------|-----|----B|------T-----|----T-----------B------------------------------f
m---B-----|--T-----|-X|----|---B-------|-----------------|----|--T------|---|--|---TE----|--------|-------------------T-------|-----|-----|--T---|-----|--X-|--T--------T------T-o--T--E----XB---------X
XXXXXXXXXXXXXXXXXXXXXXXXXXXXXXXXXXXXXXXXXXXXXXXXXXXXXXXXXXXXXXXXXXXXXXXXXXXXXXXXXXXXXXXXXXXXXXXXXXXXXXXXXXXXXXXXXXXXXXXXXXXXXXXXXXXXXXXXXXXXXXXXXXXXXXXXXXXXXXXXXXXXXXXXXXXXXXXXXXXXXXXXXXXXXXXXXXXXXXXX
