--------------------------------------------------------------------------------------------------------------------------------------------------------------------------------------------------------
-X---o-Moo-------X-X-oB-E-X--XoBoM--E-MX-M----o-----?-BX---X---B---M---B---BX-EB--o-E--X-----EB--?--M---X-Bo---XX--M--E------B---MXXo-o-----oB----X------X--?-BM-E----X--ooo----?---?M-??-------B--E--M-
---o-----BE--E----?-E-X-T---?B-o??X-X-X-Eo-M-E---B--EXM---Eo----o---------?---o----o---MX---M--?----M------E--o-----o--?---?---M-Bo----?B--M-?B-o---Eo-E--X--XM--M------B-E-M------o---BE-ME--o--oEE?o--
----E--o----M-ME?---E?-X-oMoo-MX----M-o--o---EX------o--Mo--X--M-?o---------M?---M------E------B---E-?--M-----X----o--ooEE-EMEM-----X?-E-M--EE---?--E----EE-?---?-M?-?M?Bo--B-ME-o----------------o-----
----?---oX--X--X-ME?-----o---B---EXB-B-?---BMBX-B--?--o?oXXXE--------M-o-?---XM--E---B-E-o--Bo-?-X--?M-E-o--BBE-----XoB-?-M----?------------EM--------B-----B-----M--XX--?--------E-BX-X?-B-?------?oo--
-o---M-?---X-------------MoX-----E---B--XM---M-X----BMXE--EB------X--X-B--ME-B---EB-B-EMo---B----------EMB-M-XX-?--MM-M---M--?oEM?---?-?XE-X-EX-------B--?---o---------------XE-M-oX-B--E--XX?--?o-E----
-o--------?-E-E-o--M-EB-?-o---E-----M-M--M------o------------------XM-XX-----o-B-------o---X----B---XX-XEB-MX----o?XB--Bo-o-----X-------?-o--o-MoM-EE-----Mo?-BXXo-?--E-?EX--E-o--EEE-----X-MB-???B-----
-----o---E--M-|----o-M?--BBX-XBEE----X------M--B-----EB-??---Mo-BM-----------B-X----X-?--?-----X-M-B?--------M--XE--XEB-?----BX---B--------o---X------M--B-|-B--?----------?--o--BX-E-B---------?----E-v
-E--?-------XX---Eo-------B-?-?-----?---E--M?-------o-------B----B----oMBMoB-o-XE?----------?X-------MBM-----T-MB-------?E---oX---X---o-E-BEM?--o??--E--B-X-Mo--------X----E---X---oX-oMX----EBEM----oof
---E-B----o----------?---o---B---MM---oo-o-BM------E-------X--BMM----X--Mo-BX-Xo?---o--E-?---E--oXB-E----E--?-E-----------X-?------o----Eo------?-E--E-E--B----M-M------XM?TB-?-----?----o--Eo---?-o-M-f
-M--o--EM------M--------M-----o-------o--oMXEM?----M-X----E---BM----------MXo--------EM--|----X-----E---?-?o--M---o-o-?XX---------XMX-B-----E-?------?X-Xoo-?---X--?----|M----ME---?o-?-Boo-?----------f
--B-XME-M-E-?-B?------B---X-----o------?X---EX--MB----?---M--?E----MM--oM-X----o-Bo-Xo---?-----o-?o-M---B-|BB---BE--|----EE?M-----o--B--EM---X--M?--EM?----XX-MX--?-----?M?-----M---BX----o--?--o---oM-f
--??Mo-o-----XE-BX-o--E-o--X-E----o-----?X--MX?----X-M-Bo--M---X-o-E----o----o-----?M---X-BB----B---M------ME---X---B-----?----------BB---o--o------o-EE--X-XX-X--MM----MB-B?-E--B-------XE?M------M---f
-----o----XB--?---oEX---EB--EX---M-oo?-?-BMoXXXM--B-----B---MB-?-B-B?-B---B--B-E--------E--??-Mo----XEX-o--Xo----EoMM?-----X-------E-M?o--X--|-?oo----ME--E?-M---EM-M?-o--MXX---X----?--?B---o---EM-?--f
m------Xo----------EoX--X-MM--B--E--------o---?B--?-o---o--ooB-?oBX?M---X---?--?--?----M-?---?-M----MMX-oB-o-E-------M-o------B-?--E-B--o-M---------oo--o-B-?---E---X--o-EM------M?--oE-?-X-B-MX--T--?-X
XXXXXXXXXXXXXXXXXXXXXXXXXXXXXXXXXXXXXXXXXXXXXXXXXXXXXXXXXXXXXXXXXXXXXXXXXXXXXXXXXXXXXXXXXXXXXXXXXXXXXXXXXXXXXXXXXXXXXXXXXXXXXXXXXXXXXXXXXXXXXXXXXXXXXXXXXXXXXXXXXXXXXXXXXXXXXXXXXXXXXXXXXXXXXXXXXXXXXXXX
