--------------B-----------------------------------------B-------B----------------------------------B---------------------------o------------------------------------------------------------B-----------
---------------------------------------------------------------------------------------------------------------------------------------------------------------------------------------------------B----
----------------B----------------------------------B----------------------------------------------------------------------o-------------------------------------------------B---------------------------
-----------------------------------------------------------B----------------------------------------B---------------------------------------------------------------B-----------------------------------
---------------B---------------------------------------------B--------B-B-----------------B-------------------------------------------------B---------------------------------------------B-------------
------------------o----B-------B---------B-----------------------B-------------------------------B------------------------------------------------------------------------------------------------------
---------------------------------------B------------B------------------------------------------------------------------------------------------------------------B---------------------B--o-------------
-----------------------------o---------------------B------------------------------------------------------------------------------------------B--------------------------------------------------------v
-------------------------------------B-------------------------------------------------B-----------------------------------------------------------------------B--------------------B-------B----------f
--------------------------------B-----------------------------------------B------------------B----------------------------B----------------------------------------------------------------------------f
------------------------------------------------------------------B--------------------------B------------B--------------------------------------B-------------------------------------?---------------f
----------?-------------------------------T--------------T------------------------------B------B--T----B-------------------------------T--------------------T-------------------------------?T---------f
-------------------T--B--------------B-T--|--------------|----------------------T-----------------|------------------------------------|B------------M------|---B-B--------------------------|---------f
------------?------|-------------------|--|-----T--------|----X-----------------|--T--------------|--------B-----------------T---------|----T-------?-T-----|----------------T---------------|---------f
m-------T----T-----|---B---------------|--|----E|--------|--TE---------------XB-|--|------B-------|--------T--------T--ET----|---------|----|---------|----B|X---------T-B---|-o-------B-T---|---------X
XXXXXXXXXXXXXXXXXXXXXXXXXXXXXXXXXXXXXXXXXXXXXXXXXXXXXXXXXXXXXXXXXXXXXXXXXXXXXXXXXXXXXXXXXXXXXXXXXXXXXXXXXXXXXXXXXXXXXXXXXXXXXXXXXXXXXXXXXXXXXXXXXXXXXXXXXXXXXXXXXXXXXXXXXXXXXXXXXXXXXXXXXXXXXXXXXXXXXXXX
