--------------------------------------------------------------------------------------------------------------------------------------------------------------------------------------------------------
-M--o--M---o?---XB--o-E?o--?------o----B---------E-M-----E-E-----Eo-----o-E-o--M------E---Bo-X?--oB-M--B--o---XBoB--?--------?X--E?X-X--E--------MX?-----B--MBX-?X-E--o-o-X-X---XMo-X--X-X-B--?o--?XoEX-
--M-o---X---o-------B--X---oM--o-----o------M-o-oE-M---E---B--o-BE?-o--XB---X-------B-?-E--------X-EX--XoX----------X-XEX--E-?-------X-M--BE---X-?oo-E--------?E----MB-?--o-o-E---X-?--X?M--M--X-M?BB-B-
--?--Mo----M--X-----oM-?X-BXX-----E?XEMX?--M---ME-o-o-EB------B--------XX---B--E--M-M-------E-B-?-E---o-ooM?--o-B?X-----E-M-B---MB-BoM---?--?-E-?-?-o--X----------?B?---?----oo---o?-E--ME-----MX-?E----
----?--X---BM-B-ME-Eo----?X---?-Xo-M-----M?-B-B----E-M-B-EoBXX---o---------?B--B--E?B-B-------------X-----X-oB--Xo?-XBo------oo--?X--?-oE-E-??----X----MBo-?---XM-----??---MM?B---MMBo--M-oB?------B--?-
--oE--ME-----?Mo-XE-----?---------B---oEoM--B---o---oE-E--B?o---XB--MX?----B-o--B-M?--?--M-M--X----MoX-X---Bo-X-----?---XX-o-----o---X--B?o-EB-XME---Eo---EXM-o--X-MB---BEo---X-M-----Eo------EBo-------
---EE?--------E-?XM---?-E----M-B---X?--E-XBo--M----X-o-----M-E---X-o-?-B--?--E-------E---E--BX-E--M--oM-B-E-E--------o-EE--BX---?--B---MB--M-?--o--XBE-E-----B-XM--E--E---E?-oM?o---M-?--E-E---B--M-E-B-
----M--XoooM--M?M----X--MM-B-X--o--------E-?--MEM-E--B--X-------XM-B-E-----MB-?o---M----?XEE--MT---M-B--?E--E-X--M?------BX---EoEBX---B-X---??---E?--E--B?------X----BB--B-----EM-?-------?B-------B---v
------X--------?-----?--M?-o-M-XBEo-??-----------o-?o-------------?oMM-----EB---X---E-MEXB----?-?--E-B-oX----EXo---?--X---BB-----M--X------X-X-?--E------B----?--XX-X-B---------------X-X-oE??-M---?--Bf
--M?---?-Eo-----Bo-?---oX-----o---?---?E-E-XMX-----?B---?--B-o-------------MME??---oX-?--------EEE-EM?-?-EEMEB--M-EoBM----------??E-?-M----oMoM----?X-BXEXB---E----X--?-oM----B-o-?----X---------Xo-E--f
-?--B?-o----M-X-----?E---X-E-o-M--------XEM?--XE--o--E----B-----o---M---oE-X---B--ooBM-?-?---------------B--E--B---EM---EX---B-M?--oMEB?---EM-------Mo----E?o----?---BE---X------E-B--oo-?---oBo-BEMo--f
-------M----?-o---ME-ooE--?----o?---EBM--------?--EE--?B?-EMB--oX--oBE------Xo----o--X---BM-----Bo------B-ME-XB---M--X-MMBoX-B-o----E-oX-M--M-X-B-----B----B---X?---M---?MEo-E----oM?-?-?--M-E-o-M?B-o-f
--M-----o?Xo----X-----?-E--B-X-----EM-MM-----M---M-oo---X--?--o-o--X--XM-oo--oE-M---BBX-E-o---?BX-----BoX--XBBE---X-X--o-o-?-X--B--E-B-o---M-M-----B--------???-E-----E-----M-M---oo----EMX------?-----f
--?-BE--?XX--o?B--oBo-E-MM----o--?------MB-E?---MME-----M---?-------?o----BX?-------E-------M?--MM-M----E-B----M??----BE--XB--------B--E--Xo---E--oB--XM---------X--EM-?-E-oBB-----------X-B--ME--B?-M-f
mE-----?-oo---?---B----o----E----?-----oX-E-o--MMEB---XBE--EEX----MX--X-----|-?-B------o-B-MX--------o-E-----B-o------------M---?--o-X--E-X?o---E--EX--E-----oE-E-B----?--X----E--B----M-X-XE---M-BX---X
XXXXXXXXXXXXXXXXXXXXXXXXXXXXXXXXXXXXXXXXXXXXXXXXXXXXXXXXXXXXXXXXXXXXXXXXXXXXXXXXXXXXXXXXXXXXXXXXXXXXXXXXXXXXXXXXXXXXXXXXXXXXXXXXXXXXXXXXXXXXXXXXXXXXXXXXXXXXXXXXXXXXXXXXXXXXXXXXXXXXXXXXXXXXXXXXXXXXXXXX
