-BTM-o-|EoEoTMETXEoTM-oo|TX|-ETM?B-M-oB-MoET|?Mo|MTMME|EBoXEEXT-M?oT|?|?EEoMMo?T?M-MX---|TBTBTT|-E|oM|oB?BBXooTMM?oX?M?BTMEBo|o-?TXTBX|oooEM-BTTTToTTX-EX-Eo-XTT||-MBMXMEXT-TXoTTXoE|B?TB-MoXX-o?--TBMXX
M-----?--M-TB--X--X-T-?o-TM--X-B--BBX--E-|-oB-------|EM----|B-T-XBX-M-B-oM-T?E------o----M---TB-------X--BX-T--Xo--?M-B---?--oXE-?--------X-----XX-??---T--X---M?X-Eo---E--X-X-|-o--------B-BX------X-ME
TMX-EMo--?--?------?-M-E-XM-?---?----BE--o---?---------BXM----ME-E-B---?--XE?B??-oM-X-X--B--X---X--M---X--M-EM--o---o?---M?B--?--------M-EX--M------?-?--M-----------B----E------B-X-E---?-----o-M---o--
--XXB-----X?M-X-?-?--o----------?--M?-B-o-?-o------?-X---X------MXo---E-X--M--o------o-MXo---B---XoE-?-o-----oB--oM---B-oEXM-oE---Mo----oB----XB--------M--?------BM--X---o---------o?--?-M--------B-B--
?E-M-o-o?M--o-M-X?XB--M-o---Mo----E-??B-o-M---B-?------XX---MMX?--EBE-o---MB-E?--??-M-?---?o---B-oM?--M-XM-M-----B?-X-----E------E-M----o-M---BE-BM?-----------E--------M-----M-----oE----E----o--M----X
o-----o---EX-X?---XM?-XoM-M-X-MX---M-B?o-M?--EoXoB----?---?-?--?B--o----M---?--o---X------EX-oE-?---M--M-X-E-------X---?--?------E-E---E-?------E--------?----------------------o-M------MEXX-----o--EET
M---BB-M-XM--MX--E----B--o-MX----X-B--------?------------E---------X--?B--E----X--B-M--MBB-E----ME-MBoo----M-o-?-oE---X?-------oE-?---?-M-XB--B------M--oE----Eo--M---B-----?-----?---E----?o-MB---B--?X
BX?X---o-X--X---X-?-M-?----E-o--o---M--E------BB?-M--?--o-XB-----??--X----X----E-E-E---------E-XE-----X-XB----B----BEE---EoB----M----E--E--X--E-o------MB??---B?E-----oB-o-M-------o--EX-M-----Mo-----Xv
?-?-?--E-o--B--X--X-?--E----X---o----?B-------B---X-XEX?--M----E--?---------EM-----------B--E--E-X-o---EB-------E--??------Mo----ME------B---E--BB--Eo-E-o-?---BE--oB-E---------EM?o------X-E----o-M---X
TB----X-EME-E-E-------BE-E--X-----X---B---B---B-o-B?--?--Eo--E----XX-X-B-M?------?---M----?o----?--X-E---?B-?--E-----------o--??---EXB--M---X---?-X---?X-------X--MBo--X-B-------E---oB?B------o?------T
?X?-X---o?-----o--B-----E-X?--?-B-----M---MBXM-?------X-Mo---?M---BB?---M--o----Xo--X-MBBEMEB-?-M---B-BoB?-E--M?X-M--B--X-XoEoE-o----EX--?-E-X-X-o------o-E--BM---XX?-oB?---E----XM--EM-?----------BX---
X-B--BB------E-BM--M?-Xo-E??-E--B----?B----M-M------M--------?--M---o----------Xo----E---BM-B----X---E----EMX--?----E-------B------B-M?--MX-o----E-----M-?M---Xo?MEM-E------X-X-M-B-?--M--M--M----E----?
E--?-M----XMo-?--o?oXM--o--?-MB----?--?X-----X-X---M-B-----------E---BE-M---o------EB---X-X--o-o--?----------o?XX----XX-X---E----??-E---B-----M---oB-M-----E--E--------B-?-?X---BX-o?-?M---M-----o------
|---?--M--M-oMB-o--EB-M-------X--oBM----X-X--?BX-o--?E--X----B?-X---?--B-E-?--EB----M-E-----?--B-E--o--B--o-E?----B-X-X----BX-?---B--X??B--o---B--M-?EM----E-o-?--?---BX-----B-Eo?---XX-B-B--MX?B--?-o?M
mM-o--?-MM-X-----E-B--E--E--MXo---E--B?BB?---B-?--EB--B---XBXo-------o-E?--o-EE??X?MEE-----oBo----------?oo--B-?----M-X?E----o------X------B--E---X?X-MXB---M?-Mo-X----B-----------M--M---M-?-?-?X-o---B
XXXXXXXXXXXXXXXXXXXXXXXXXXXXXXXXXXXXXXXXXXXXXXXXXXXXXXXXXXXXXXXXXXXXXXXXXXXXXXXXXXXXXXXXXXXXXXXXXXXXXXXXXXXXXXXXXXXXXXXXXXXXXXXXXXXXXXXXXXXXXXXXXXXXXXXXXXXXXXXXXXXXXXXXXXXXXXXXXXXXXXXXXXXXXXXXXXXXXXXX
