-BTM-o-|EoEoTMETXEoTM-oo|TX|-ETM?B-M-oB-MoET|?Mo|MTMME|EBoXEEXT-M?oT|?|?EEoMMo?T?M-MX---|TBTBTT|-E|oM|oB?BBXooTMM?oX?M?BTMEBo|o-?TXTBX|oooEM-BTTTToTTX-EX-Eo-XTT||-MBMXMEXT-TXoTTXoE|B?TB-MoXX-o?--TBMXX
MX---?--?-|--E--EToM-o-B-MX---?BE?X-XB-o-o|-o-------M?--?--o--B-X-o--E-?MB-o-T?-?E---------E|?o---M--X--Eo--E-M--BB--X----E----------M----|X-oEo?-o-----o--X-X?----T?---oo--|M---M-T----TX--?X------?--E
TB-o-XX--?---B--?--??XM--B------B---EB--o-?-----X--?-M--XX-M-------------o-E----M--X--o-EM---X--o?X--XM----o------M--E----M--?MX---------------B---EX--X-M--------o---M-M?----?--X-?-oM----o---XMo---o--
--X?--B--o--M-?E--?-M-BB-?-B-?----XB---X?-----X--M---X-------E--------B-X-B---M---B-o----B--------?M--EB-?B-MX?-BBME-oM---E-oEE---------X---oo-E----B--X-M------o-------?B------ooE--o-o-M-XX-M--o--o---
?E-----Eo-M-o-Moo-----o-X--M--X--?---X---XM-B---EBMMB-B---o---X-o--o-M--------Mo--?-Bo---?--X---------o-MM-------BB---X----M----??--?------BB-o----?ME--M-E-E---------------o----M-------M---MM-o-?----X
oM?--E-B-XooX?----MB?-o-o---M-XXXB---X?--B--BE-B----XM??--oX--------E--B----X-X-X--X----MB------X-B-o---E-M-----oo-?B--X--Mo---o------o----M-?-M-EoE--oo-?XM--X-?--------ME----------------X------X--BoT
M--?E-------BMEMXMXB-X-?---M-E--o-E-XM-M-XB-B-M-o-X--?-------E?M--M----?EE---BBE--?B------X-----X---E-------?-??-M-?------B-------X-E-X--?----Xo?----X---------E--E-B-----E---EE---X?---M-o--B---?---E-X
BXEo-X--??--X?-o---------MB-?oE?--B-?E-XX-?---?B-o-M-M?---?B--?M-B-M?-X----B---??--E----E-----X-B-?-M-E??-----B-X------o-E-E--?M---?-E---o------X-?-------------E----?E-o-X--MBM-M-B-X---Mo--XXE-----EMv
?-E------B---X-o-o-M?---?------B?-?XM--?--E-o----B----?M----M---MB---o---?-----XoX---?--X----MXM--B----?MB---E--B?--?-oo-------X------o---B--B?--E----M--o--M--?o---MX-M----X--B--o-o--M----B--B-----E-X
T---E--BM-------o-----?--E--M-?o--M----X--B--MB---XXBEX----B--X---X-Bo--EB---B-----------M?XBo-----Bo--XX-BE--------------E--M---M-ME--M-----X---E--?--MB?-------B--?-o--------XM-----B---B--X---o-oX--T
?XE---BB---B----?------o---B----B--M-?-X----E-MMXX-?o-XX---B---M-----X--M-------M-B-XoE--o-o-M--?X--B-?------------?-?-?XM---o-----o?----------MEo-------E-ooX-BB-X-Xoo----------E-----E-----X--o-?o--?-
X-------?-----B----X---XE-E?B?-?ME----oX---?-E-M----B-MM---EM---B?-M-?----E-XE--?---o-BX-?--?----X-?E--Xo?-M---M-M-X---o--?--MM---?--o---o---X-XoB------E-M---XoB---M--E-M--X--EE----Mo-----o-X--?-M---?
E---E-?--X--o--oM--oX------?-M-E---B--?B----EB--??B--M-B-Mo--??-----M-MBE?--oX--?---B-o--?X-E-------X---M---?-X-----XX-E-E---B-o---BB--M-??-X-------B---B--?----o--?---X-?-MX-----XMM-BX-B---?-?-?----M-
|--B-E---E?---E----?o---------B------o----oB-?-X--EE--M---o----XB--X----?----oB--o-E---------M-?E?--?M-----B?----M-E--B-?-----------?MM-MEE---B-M---B-Xo-?oB--X----E-??M-?B-------------EB-XMBB-BB?--o-M
m-o---?o-BB---?-Bo---o-------XE--X?-BE--------?E--XBM-------X-B?BEX??------EM--?--?-E-BMBE?X-----X-?-?--M?--E--------BX--?-?--o----E-----ME------?----?o-EM---EBo------o------?--M--E-XM?----BM----BE--B
XXXXXXXXXXXXXXXXXXXXXXXXXXXXXXXXXXXXXXXXXXXXXXXXXXXXXXXXXXXXXXXXXXXXXXXXXXXXXXXXXXXXXXXXXXXXXXXXXXXXXXXXXXXXXXXXXXXXXXXXXXXXXXXXXXXXXXXXXXXXXXXXXXXXXXXXXXXXXXXXXXXXXXXXXXXXXXXXXXXXXXXXXXXXXXXXXXXXXXXX
