--------------------------------------------------------------------------------------------------------------------------------------------------------------------------------------------------------
-M?-----M---?-E----E-----M---?-?-ME--XE-E-X--o--E-B?oEM-X----X-?----B-E-----------X-ooMM--Bo----E-E-?--E--Eo----------E----E?EM--X--BB?-BBB-M----M-------X-BBo-Mo-o-M---o-o-?MX--?E----B-MM-B-EXB-?B-E?-
-------------B--B--BE--o--?--XMo--o-------?-o-Eo------B--X?--E-?EE-E?------M?---M-X?--B-E-XX-EE--------Bo----oEX-----X--?--XoE?E---XX?-B-X-----?---o-B-M----XEBXTM-o--BXX-?---Xo---------M-----|B--B----
-EM------ooE-EX-E----M?X-?--EBE-o-o?-------------BM------o---E-?--o-XoM---XX--XE-------MX----MM-------E-BX-o-XMXX?E--Mo?E-?-M-MM-?-----MXX--?--XB-oBo??---------M--M-XM-?---XX--B-?XE???-X-oB-E-?Xo--?E-
-M----o----Mo-E-Bo-E-Mo--------------o---?-----MB--ME-BX--oX---M-Bo-------BB--?--------B-M---o----X-XXXBoME-o--oX--M---oMX--X--M----o-----M--?---------MM--E--XoB--o?-----B----B------o-o?--X---oB--XBM-
----M----B--M--E-M------X--------o----B---B----|-BMo-----E?---E?XB----X?o-X----?-X--BB--Bo--o----o-M---E---o?Bo--XBo?--?--?o?--EoX--BX-o-o--B-EBM--B?M-MM-B-Bo?B----E--EE-?--o--MBEX-o--?---oBoBB----B--
-----MB-o--BE-M------o-o-B--o-----E-X---X-M---XE-T?-??-M-EB---X?-XXoE--E-BX-------EBM--------BoM--BB-----B-X?---?--??--B---oB?-|------M---M-M-B-----?---X----B----------M--E---?X-MM----EM?X----------E-
--M-X---?-o-B---X---o-oM?---------X-o-M------M-X-MM-------o---?M--MBX-o----M----XX-oo-M-o?-----o--ToEX-?M---M----BX---oo-B---B--X-------o-BX--?M-X---oE---oo-B--E--B---BX---EE-M-MXM-ME-B?---E--M---XoEv
----E---M-----?B?--E--?X-M--?-?X-X---?o-X-oEE-MEB-XX?o-E-?--M-?--B----M-Eo-oX-----E--M----o--?-X---X--X-E--B---?---------M--o-M---?BBoX-?BB----EB??oB----o----E--B-o--M-E-M?----------XoX-XX-?----X-B-Mf
--?B----o---E-----E--------MX------BM-EE---?MXE--ME---M---XE---oM---------X---EB--M?oE---X--?-BEEB--B-E?---X-------?----X-o----X-M-MX?--E--B--M--?E-EEX--X-?EM--E-----------X-----X-E-----o-XM---X--X-?f
--XM-M----Xo----o-X-B?o?---B---E-o?---X--E----X?-X--B--?-X---?-Xo-M--EB-oEME---------------o--M-o-?E--oB--?X-E--BE---E-B-EEX?B-EX-------EMoE-----ooXMX-----B-E---E-o-?--------o--BE--?B----BB---------Ef
-?----B-BE?--oo--------XM--Xo---M?----M-E------oMMB-X--M--oB---oB-----EM---MX--?oM-?-Xo-----EB---B-X---XMBBB--M--BXMo-----BM-?---?-M--X-ME---E---X----E----X----EM-oXBo---------o--ME-M-MM---MXBoo-o---f
----E-X--X-----X--XXEM---X------X--M---M--M-BM-BXM-Mo--B--oo?B--X-X------o-XE--X-B--------X--?-B-?------X-M-E----E--Xo--X-E---M--?-?-E-E----?XBM-o---Mo-X-oE--?oE--?--?-X--oMo--oE-----M--X-X?----M---Mf
-----M------M-?-o-E??X-oE--o---M-X---MB-B-M--BB---EM-o-X-----E-X-E-MX-?--M-B-M---MX-----MX-o-EE---?--E---o----BM--B--------E-o----M--M-o----XoM--B---E-o-X?X-----oM-----oE---MMo---oo-------E-------B--f
m-----BoM--?---M---?-MB--XB--E--B---B-----B-------?--E-o-Eoo-MoE??EEXBX------EM-XoXMX-M-?-----?--E-X---M--?o-B-X-?X-Bo-M----B-?o-----XX----B------BBBT?----M-----?-?M--E--E?------M----o-------?-M-?-?MX
XXXXXXXXXXXXXXXXXXXXXXXXXXXXXXXXXXXXXXXXXXXXXXXXXXXXXXXXXXXXXXXXXXXXXXXXXXXXXXXXXXXXXXXXXXXXXXXXXXXXXXXXXXXXXXXXXXXXXXXXXXXXXXXXXXXXXXXXXXXXXXXXXXXXXXXXXXXXXXXXXXXXXXXXXXXXXXXXXXXXXXXXXXXXXXXXXXXXXXXX
