oTooXoooo-?oTEX?-ETMM|EMMo-o|ToEoToM-?M|XT||?--BoBEM|o--EBBT-Mo-?Eo|E-MTT?oM-E|XB|TE-E?oM|?-MoBTE-X?-MB|o?BEE|?|T-oBX|BT-o|?E-|XoXB|-Eo?EX-MX|--BXX-oXXX|M?BM-|X??-?EE|ooBB-TX-?||XoTBM|?E|T?B|?To-EEX|X
B---MM--?---M---BT-MX--B-T----?---E---|--X-ToMB---E??--E?EE-X-Bo-B-??-------M-T--B--B--M-M--?-----B-B-oE--?Xo----o?-E-B-X|EB-E|--?-----o-M---TE----XXX--X-----ETB|---------B|X?TM-oM--M------X-B|--M--Mo
BM--Mo-o---EX?-----o-o?E-?M?--B-E----EE--B-----E-M--o--BX----M----B----?-----M-----------E----?-------M-?X??-oM-E---o--oE?-BM-------?---X----B-?---M-M---M---M-M--EM-oM-M-?X-----E-E-----o----EoM-----EB
X-X--oE--o-----E?---B-EBE--EM-M-o-XB??M-oX--E-o-M?ME-o---------E-BX??-E------o--XE--o-----M--oB-B-Xo-o-?-XB----------E-M---Mo-E---M--M--o-X-------------E-----------X-----X-----BE--?o--?--E---oX------E
X?-B-----M-oB-E-XX?B-X-oX-ME-?--X-E-?-XBo--?--E-Eo----?--X-MEE--X-MM---o--X?--?--?--Eo-----o--M-o-EB?BX?-M--Bo------EB-?----------oM-E-oo---------E----------------------B--o-o------M-----EX--------M-T
?-M-o-----E-XE---X------X----o--o---------o--?-X-?--XE-Xo-o-------MoXM-B-M-MX--X--o-BEE---o--oEM-----EoXo-------XX-?-oE-?XMo-?-o------M--MM------M?EM-Xo--X---E-o--M---oX-----oE---E--XX---?----?EE---E|
B-?--M---B-X-??-M---?--E-B-?--XB-X-XEM---XBX--------ME?-?-o--X?---o----X-B---------X--B-BoX-----M---EM-----o?----M-?-XoE-o-o---oE-----?----?---B?M-E-?--------------M--ME-----??-B---B--M-------Bo-----T
E-Bo--?M--X--X-o-o-o-B--E--M-o-MXo-E--E--E-B--X--??E-----Mo--?X??---X----------E---M--B--------BE-E----M-B--X?---B--E-o--M-?o--MX-X??E-?E-X-----------o--?BM--MoE-------?X--M--E-o-B--E---X-B-oE-----EBv
M-?-?--oBE-XB-----X--M-X---M?Eo??B-o----M--M-o-----?EXo-B?o-oX-----------M?-BX--M--E-MX-B?--Mo-E-o-----M-----E??MXMEEX-o--X-MXM-?-E---o-?-o-B----M-X--oEXo-----?---Bo-E----E---o--oo---o-o------M------X
XMB-E---M-?MB-B----X-----?-M?E?M--B-oBoB---?--MXo?-E---B---M--B?----BX---BB?M--?B-?-X----------?--MM-----?--MXX--B------E-B-----X-X?-X--------o-?Eo-?-B--M-X------MB---X-E-o-?M?--?-B------------o--o--T
T----oB-M---------B--------------EX?--MB?MXB---?---?-BX?M---o-XM--o----o-B------o-X--o-X----X-X-EB----B----o------o---MEo--o-o----BX-??-oB---M--M---M---X--X--BE-E--?--B-X---------M--oM-----X-M--------
--B-?-E-----B---o-BM-B-X---MEX--ME----?--o---oo------o---BB-----o--E---?M-o-M---EE--o--B?-------EX---MXE----X----EM-EB-o----------?-?M--?-Mo---?B--EX--BE--?-oooo?B?-E-M----X-X-X--?-Eo----M--B--o----?X
|---B-?--E----------------X--MXEB--oX---XE---XME---o?-?---?---?------B-----?E-oE----B-------X-?BB-E-----E---BMXM-E-E--MMX---MB-X---BXB?ME?--BB---B-BX--M-?-------MM?M-MEE----------XXo--?X-B---o?---M?-E
B--B-MB----?--E---?-o----X----B-BB-----?--E---MX-M--?-?-X-?MB-M-X------M--B?-M----ME--------X--?--X-XB-B-----o-----EXX--o-------o-------M-M----?E-o-B?Eo-o-----?---B--?--?BE---E-M--?----M----B-B--XEoM-
m----B-B-X--M--?-EX--o----?--BB-X--B-B--??oX-B----EBo-Bo---X?-o-B---?E---E-E--MXoXE-XM-B-EMX-Mo----X-B----oo-----Eo--M-X-?o----MoX-------M-----EX-----oB----M------?--?--X---XEM--B-o--M-B-?---??M---EB-
XXXXXXXXXXXXXXXXXXXXXXXXXXXXXXXXXXXXXXXXXXXXXXXXXXXXXXXXXXXXXXXXXXXXXXXXXXXXXXXXXXXXXXXXXXXXXXXXXXXXXXXXXXXXXXXXXXXXXXXXXXXXXXXXXXXXXXXXXXXXXXXXXXXXXXXXXXXXXXXXXXXXXXXXXXXXXXXXXXXXXXXXXXXXXXXXXXXXXXXX
