----------------------------------M-----------------------------------o---------------------------------------------------------------------------------------------------------------------------------
---------------------------B----------------------------------------------------------------------------------------------------------------------------------------------------------------------------
-----------M---------------------------o--------------------------------------------------------------------------------------------------------------XXXX-------------------------------B-o------------
-------------------------------------------------------------------X-------------------------------------------------------------------------------------------------B-------------B----------------o---
-----------------?--------------------------------X---------------X--------------------------------------------------------------------------------------------------------------------B----------o-----
---------------------------------------o--------------------------BBBB------o----------------------------------------------------------------------------------------------------------?----------------
------------X-----------------------------------------------------X------------------------------????---------------------------------------------------------------------------------------------------
---------------------------------B------BBBBBBBB-----------------XX---BBBB---?-o-------------------------------------------------------------------------------------------------------o-?---------XXXXv
----------------------------------BBBBBBB---M------------XX--X--XXX-----------------M----------------------------------------------------------o--------------X-------------------------------------X--f
-------------------------X-----M-----------B-M--------------XX-XXXX--------------X--------------------------------------------------------------XXX---------------------------------X--------------XX--f
------------------------------o---BBBBBBM-M?---------------XXXXXXXX-------------?---------------------------------------------------------------------------------------------------M---X---------XXX--f
-------------------------------------B----o-------X-------XXXXXXXXX-o------------------------o----?---T-------------------------X----------------------------------BB------M---?T-------XX----XXXXXXX--f
-----------o-------------------------BB----------XX------XXXXXXXTXX-------BBBBBB-o-----------o--------|------------------------------------------??TT-------XX------------------|-------XXX-----XXXXX--f
------------------X-----??????X---------------B-XXX-----XXXXXXXX|XX-------------?---------------------|--------------------------------------------||---------------------------|------TXXXX---XXXXXX--f
m-------------EE------------XXX-E-----B-------XXXXX-E--XXXXXXXXX|XX----------E------------------------|---------------------------------E----------||--------M--oo-X---E----E---|------|XXXXXEXXXXXXX--X
XXXXXXXXXXXX----XXXXXXX----oXXXBXXXXXXXXXXXX--XXXXX---XXXXXXXXXX|XX--XXX-----?----XXXXXXXXXXXXXXXXXXXB|XXXXXXXXBBBBBXXXXXXXXXXXXXXXX--------XXXXMXX||XX-XX?----XXXXXX-XXXXXXXXXX|XXXXXX|XXXXXXXXXXXXXXXX
