---------------------------------------B-------------------------------------o-----------------------------------------o--------------------------------B-----------------------------------------------
---B--------------------------------B----------------------------------------------------------------o-------------------------B----oo---------B---------------------------B----------------------------
-------------------------------------------o-------------B----------------B-----------------------B-------B----------------------------------------------------------B----------------------------------
----------------------------------------------------------------------------------------------------------------------------------------------------------------------------------------------------B---
-------------------------------------o-------------------------------------------------------B--------o--------------------------------------------------------------------B----------------------------
---------------------o-------------B--------------------------------------------------------------------------------------------------------------------------------------------------------------------
------------------------------------------------------B-----------------------------------------------------------------------------------------B------B------------B-----------------------------------
----------------------------------------B---------------------------------B------B-------------------------------------------B-------------------------------------------B-----------B-----------------v
--B--B---------------------------------------B-------------------------------------------------------------------------------------B----------B--------------------------------------------------------f
-B-------B---------------B-------------------------------B--------------------------------------B-------------------B----------------------------------------------------------------------------------f
------------------------------------------------------------o------------B--?---B---------------------------------------------------------------B-----------------------B-------B----------------------f
--------------T---------T--T---------------------------B-------------------------------------B-------------------------------------B---------------------------o------------T--------------------------f
--------------|---------|--|----------------------------------------B---------------------------------------T-o--T---------------------------------------------------------B|-----------------o--------f
--------------|--------B|--|------T----------------X-----------------------------------M---------------T----|----|----------------------------T-----------------------------|--------------------------f
m-------------|---------|--|------|-----------------------T------------------T----B--------------------|----|----|----T-----------------------|--E---T----------------------|--------E-----------------X
XXXXXXXXXXXXXXXXXXXXXXXXXXXXXXXXXXXXXXXXXXXXXXXXXXXXXXXXXXXXXXXXXXXXXXXXXXXXXXXXXXXXXXXXXXXXXXXXXXXXXXXXXXXXXXXXXXXXXXXXXXXXXXXXXXXXXXXXXXXXXXXXXXXXXXXXXXXXXXXXXXXXXXXXXXXXXXXXXXXXXXXXXXXXXXXXXXXXXXXX
