--------------------------------------------------------------------------------------------------------------------------------------------------------------------------------------------------------
------------E-?o-o----------X------B------M?-----E----B--B-o-X---o----B-----o--BB--?--MM-BM-MX--EEXEM--M----B-X--oE--o--X---?---EB-XM---E--XB---E-B--X----?-oB-??---?BEBB---XM-XXXE---?-?E-B--BXM-??MX--
-----ME-M--E------E---E--E-o?E------BM-?X-?E--X-o--M-X--?--oEE---E--?---B-M??o-----?--B--o-E--M---EEX---------??-E-?-X--X-Bo-B-EE--XBX--E--X-------M-M---E--XE-E-EB-Mo-?o--E?-oX---XMMEXX-o-?-X--B------
--?---M-Bo----E-?--E-?B?-----X----E--Bo----X---?E--B---?B----??BE-----X----?-BM-X-o-o-B---M-E--X-MX--BB-EX--E?o?B-EE----|-B-----?----o---?-o-B-o-E---MEM---E--?--X--?XBE--X--X?--Xo?E--B-MBXMB-----Eo---
-----o-M--oE----M-M--B---BEE---X?M-BM----?---Bo---oM--o---BBXXX----------o-?EX----o?--M------------?X?oX-B----?EM-B-?oB?-----ooX--?---X-X----B----B---BM----X--?X--?----BMB??---XEX-X-o----o--BM-----B?-
--E--oM--B--M?-?-X--B-MB----?-B--XB|---Xo-M-X-M-?----XMEoMo?-E--M?-M-oo-E-E-------M---o--o-?--X-B------o--?-XX----M--E-?-MEo---B------------E-----XXo---o---MM--?---o?X-?---MEXo-----o?-------oX-----E?-
---E-MM--E---E------E------o-M--XM-?-M-E--M-E-oX-B--o------?--??oM-------XMM--?-ME--?-------o-o-?ooEo-M-B--?-----o--B-B--o----B-E-XB-X?-Bo?----X-M----?EEX---BBE-X---?---XBoBo-E-E-----?---EEo?---?-X?o-
--E-MEMBM-------M-----o--o-X?X---o--?B--------o------?-------X-?-ME-oEo---XM-X--B-E--E----E--oE---XM-o---E-o--X--??-MB----X--BB------o-M----B-?--E--EX--?E-------MBX?E--MX--oE-X----B?M--??XM-M?X---B-Ev
-------------------oB----?-?o-B?M---XBoX?--?M-B-BB--o----B-?-E-M?--MX--B---------?-o-M-----M-MB-EM-X-X--o---BE----------BX-Xo-?---?E------X-oXo-B-E-B----B?-X--E-MX--Bo--------?----M-o---BX?-MM---X-MBf
--Mo---?-EX?XE?o--o--------M-BEB-o-o--?E---T?--X-M--?--oo-----Bo-------?---X?E-?-M-oXoE?-----?-M---EXXX--E--------Mo-B-M|-M--o-?-o--B-----X-M-EE--B-XB?---B----M-o----BB----M---M--BB?-?----X---E?--EETf
-o-?XB--?E--?Xo--XB--?oo--??-----------XXMM-o---Bo?--XME-B------oo---XX-o----?o-----E--?-------XoX-B-Bo-B--E??-----B---X-X---BoE-Bo---B----EoX---Boo-oMXB------EBB-??-E?-E?Mo---E-X-B-----XB---EXEE----f
-?-----X-----E---B-Mo--MM-?-------B----oXEM--o----------------XB--M-B?-?--X--o--o-----XE-E--------EX---Xo--X-X----E?B----X??---B-oMM--o-Bo---EM-B-E---M-?-----Mo------o--------E--------o-------B-o?---f
-?--------M-EEX?-BEB---X-?XBXXoX----oo-E-?ME--M-----X-?-------o-X--------oo--BEE-----E-X--B-----o-M-X-E?--------B-----M----??----X------------------oBXE---E-Eo-E---XMEB-M-XM--E----?--------X?o---XM?-f
-o?--E----o-Mo--M?-o?o--MM--X--E-----------M-MX---------XB---------B-E----oE?-M--ME---X----E-B-?-X?-B------X-X---?-X---o--X-?--?--E-B-X---------XB---oE-------------BM-?-E--B--T--------?---------BX?o-f
mE--EX----B-B-------?--o-oB-EM-?-M-BM--M------Eo-----X?-M----M----M--M-?--XE----Eo----B------X-E--BE---M-----E-oo--MXM-o----------B---?-----M-----MX--?-B-B-BBB-XX?--o-T--X--o-E-?B----BM--BEBo--o-?B--X
XXXXXXXXXXXXXXXXXXXXXXXXXXXXXXXXXXXXXXXXXXXXXXXXXXXXXXXXXXXXXXXXXXXXXXXXXXXXXXXXXXXXXXXXXXXXXXXXXXXXXXXXXXXXXXXXXXXXXXXXXXXXXXXXXXXXXXXXXXXXXXXXXXXXXXXXXXXXXXXXXXXXXXXXXXXXXXXXXXXXXXXXXXXXXXXXXXXXXXXX
