--------------------------------------------------------------------------------------------------------------------------------------------------------------------------------------------------------
---Xo-oBM--ME?-?E-M-X--E--X--B--oM-XM---BMME--Xo-o---B--B-o?---E--B----E-EB-X-M?-X--BXX-o---B-EX-XBM---E--MoB-X-EMMM--BBoXX-?--o-BMMEE--oBXo---B-XB---?E-E--M-X--E---o?oM-?E?M--BB-----o-MM-E---M--?X-?-
-MMX------o---M-oMoE|-X-BBX-?---?o?-T--?EMo|-M-M-B?o?---oX|MB?-|?EMB--M-E-ooE-?X-Eo--X-MoM-EooX--EEoB-EEBo--XBM--|---M?X?B|B---X-TooE---B--oMM?E?-M-?---?-o---M-B---?XMoTo?|-?o-B-EX-o--o-??--o-|-XT?-B-
-?E-EX-BBB-oXBMo-E?BE-EEMo----MEE-?-E--o--?|Eo?B---|X-BX--E-X-BXMMBB-----BE-?MM--B-?----??B?TMTMoEXMX-E-X?-XX-|X-XB----EMT-Bo--M-|X-oEM-M--MMT-EM-o-|-EE--B--B-o-?EM|-----o-MoBXX-X--T--BB-?--o-oM?-To--
-|M---M--?------Moo-?B?--o?Bo----X-MXoo|EXo--|BXMo--o-?-B-E-ooMoB-EB-B-Bo?--?Eo-o-?---M-X-T??-E-?-|---XoMTo-EX-TEMT--oXX-B---B-oB--ET|EM|X--XT-XM---E-o---X-EEo---X?BB-o--o?---M--XBE-X-oo--??---oXM-TX-
-?MEM-oE?X--M?---B-?-?MMEE---M--X?B--X-B-M?-B-B-B----?X-|----o|M-X-o-XBMT--ET-?BoBXX-ETM-oE-M-T--B----?-B--BT|XB--M-o-X---o-MMB-X-X|-oM------TM----M--M-MB|-EoMBM-Bo--?-M------?X-MT----XB-?M-o-M?-|EB--
-------M----T--E-?M?---MEM-Xo?--Mo-?--?-B--oE-E?-----?T--?-E-M|X-T-o--TE--MX-BM?X-TX-X-XMM---X|-M?MX?--M----|-oXM----X--M-E-Mo--?Mo----M--X-----E-?E-MMB----|EB--?X---MX-MMEo---?--EM-MX-T-E-ME-BB--?oE-
----?-B-?-M?XX?-MM?MXXM|MX---TM-XX-o-XX-To--|--E-BX--?T----T-----??o---|oo--M|MX----E-ETBE---TB---M-----?-EX-oM-E-?---?--B-B-?---Xo-Bo--B-oE?--?--E--o-T---X-X?E-B-EE---M-M|X-EoE---B-o-M-o-E?M--T--o--v
-M-B?-XXE--|--?-BXM-|o-BB-EME?oE-MBo--oEE-E-o-XE--E-o-EE-BB---?o--?MMB-|B-MXBXo-o--B--?|--o-M----?-BMXBMXEX-M--oBEE-----X-o-E--B--|EM?-X--EE-B-BE-B----E?B-EE--??MX-?----EXBEM-?Boo?EB-?--Bo--TB--B--B-f
-B--E--?X--B---??-?---E-|X-oM-oo---B--------B-T|----MXET---M-o-M--M--T--MB|---?-M--oB-BEX----XXX?E?oB-XEX--??--TT-|--E-B--XEM--T---??-E----o-?-EMo-?-?--?oMoBB?---|E-X---B-X-X--M-E-TE-M------o-B?X--X-f
-?o-M?MX-o-B-M?-XX?E?M--o--TE?--------X-M--M--|M---EoTM-Eo-E-M?--XM?BM?-|-|-MM--o-XooB----?--BT-?--BB-|-XXBTE--To--o-?-X--|--BMX--M-B?T---X|---B-Bo-?---B|MXE-T-?E--MBoMM--Bo------ME-ME------X-MBB---?f
--B?BETE-X--?oEMEB--|XMBoX-oB--?BX?-EM-E--B---B-X-B-E-X-|--E--?-M-oB|-?-E-?---?X|o?ME--M-B?M?MX-o--oM-TB--BE?-?T--X-oX---XXM-E---BMo|-|X-E|--E--MB-oT?X-MB--T--X------MM?BXBXXX-XB-|---E--E-o------XMM-f
-M-T-BMM-E-oo-ooBBXo--|-o-EBXB---ME-BT?-M---??-------MM-B-MTX-X-TBE-?XT-BX-?-X-M?TB--XEoM-BB?-o-TX-E-X------o-??--?----E?-XMX?---o--M--B-----M-X---E-E|MMB-E-?MX-E-B?B-?-T|---EM?-Moo----M-BoMX-EBXM|MXf
---M-Boo?M-X---?--E--MT-o?E-o-?--o--MM-?E--M|MM--BB-?B?oTB-|-----M--M?M--XB-X-M?BM|-M?BXX---o?|-o--|o-BM-------M--E?-BM-XE?---E---X?To-?EXX--M-B?XMoX|?|MoooE?-|-E-E-M-T-ET-o-oT--M-----?MB---E-ET--|--f
mB--XTM--E?T-?M-o-|o-oM--B---M-Xo-----BETM-oB--XBo---o?-o--o-?---|B-XXB-X--B?EXoX-|?-BM?M----XT---?EX-T----B-EMEB--E-----T-----X--|?XBE--E----X?|M?-|----TEX?EX--?o-MX-oB-BM-X-TM-M--?--??-oE-?--oMBEXMX
XXXXXXXXXXXXXXXXXXXXXXXXXXXXXXXXXXXXXXXXXXXXXXXXXXXXXXXXXXXXXXXXXXXXXXXXXXXXXXXXXXXXXXXXXXXXXXXXXXXXXXXXXXXXXXXXXXXXXXXXXXXXXXXXXXXXXXXXXXXXXXXXXXXXXXXXXXXXXXXXXXXXXXXXXXXXXXXXXXXXXXXXXXXXXXXXXXXXXXXX
