--------------------------------------------------------------------------------------------------------------------------------------------------------------------------------------------------------
----M----BB------B---E--?----E---E--XM-----E-?----oM---o?---M-BE--oE--?-X--XB-----Mo---X--?-B----?---o--E----oB---XX--------o-B---X-?----?-X-E-----o--EM---MB------B---------M--B--B-oX-??----oM--?---X-
---?------M--B--?------B-X----o---------B---M---?----E-?--E?-?---o-------MX?--o--X-Eo-X-B-------?--X--?---ME-o-E-M-X-o-?-BoB-----E---------E-?----E---X-ME---?E-------oX---E--BX-MX----oM----?----E-X-?-
-------?-----B-----X-?--XE--MoX--EE-XE-E-Bo-B--XBX-EE---?--T-o?--------Xo?-?--?E-----X-?MM---------o---------?E----E-?-M-E---?-M-----------?-M-----E---?----?---B--M-EX?oo---o-------ME------MMM--E---?-
--?-o--X---oX----o--M-B--------o--?-??---B?-M--X?MMEEoME-BM?X----------o?-?--X----XM---X?-----------o--oB--E----------B---M-M?EBME---------B-----B-XB?-E-B---M-o--X-X-X?-X--Eo-----X--M---------o-B-M---
------------XE--?oEB----oB?---E------oBo-------M---Bo?----X-E--?-X-M---B--M--E-oB--X-?---B----X--E----oE-M--o-----------oXB---BE-M?-BX---MXX-?o----?-----?------?------o--------M----o--M?---?---?-EX---
-B?---?-MM--?---EooX---B-X----X?---MXo----B-----B-----o--M----------?---BM-o---B---------M-----Xoo--M-X--Bo--B-----?-o---?---B-XBB--ET--------o?X?-M---M-o------?-----M-?o-o?o--------B---X--?E--MB--B?-
--MXE-?-------B-?E--B-E--Xo------o--E-B-----?---------B--BE-------oE?-------?MM----oo?-E--o--MX-o------ME--------Mo-----?T-EM-Eo-?---?--X--M-?o--X----X?XE----?-----E-M-----?-?oo-o--M-M---??M?-M---?-?v
---o--B--o---E-B-?-oo-T-------B---Eo----oX-o?---X---ME--E?--BE---------B?-E---?--X--E-BoMoB-?-?-?------o---MX--------M-BoE---B-oE--o--M--B-----?E----B?--o?--B-Mo-X------B-------------M----E-X--------f
----Mo---E------M---BBB-BB-------?-?-B--------------?-XX--M--MX---B-E--TX?-B--o--X-M----BME-XBXo----EoX?---oM-----M-B?EoX--MM-?-X---o-EXB-o-?--o-B-----o--oo-?oME?-B-o--X?-----B-E-----M--X-EX-X-oE-o--f
--------EE-o--X-M--?--------XBX------MBEEE-X---M------o--oE-MM---Bo-M-----o-X---?----B--E-X---oE--M----B-o------XM----M------?--------EM--BXBB??------------?|----B----?EXE----B-?-Mo----E?----?E-M----f
-XB??B?M--------E--BE--E-?o-X----E---------?-E-?---o----E--X-o-----X-o--E------M-B?-----|--XE-?X---o-o-M--?--?BX---oM---M-?o---M-E----???--o-M-M-??-oM---?----E-?X?---------M-B-BM--BB-XX----?B------B-f
--?----E-Bo---Eo--?M-X-X-----o-X-oo-----X-BB--B----ME--M?o?o-MB-o------o-----B?--X?-B---XXo---B---EB-----XM----X-X-X-E-------M--------X-BM-?-?---X-----M--X-BXB----XEEoo-X-EX---X--?----?--?-BB-X--X-B-f
-----B---------E-----??---E?----B------M-------------------?BM---B-----oE--?--E-B-----o--?-X----B----X-EX-MB--MoEXoM--EM-----X-E---MM-------X---B---o-?EB-M-----o---------M-?B--o-oXX--E--Eo-?E----EX--f
m---?---oM-Mo---B-?----E-XB-----X--M?-E-E--?EM------o----?-T--E--MoE--------X---o-?----M--?------X-----EX-E-X--X----MX------BM--o-----o----?-?---B-o-X--TX----X-?--BB--?-X-B--?----B--o------?-?-M-B--MX
XXXXXXXXXXXXXXXXXXXXXXXXXXXXXXXXXXXXXXXXXXXXXXXXXXXXXXXXXXXXXXXXXXXXXXXXXXXXXXXXXXXXXXXXXXXXXXXXXXXXXXXXXXXXXXXXXXXXXXXXXXXXXXXXXXXXXXXXXXXXXXXXXXXXXXXXXXXXXXXXXXXXXXXXXXXXXXXXXXXXXXXXXXXXXXXXXXXXXXXX
