-------X------Mo-------------------o--------------------------------------------------------------------------------------------------------------------------------------------------------------------
------------???????-------------o-------XX-M--------------------------------------------------------------------------------------------------------------------------------------------------------???-
-----------BBBBB------------B------M--------------------------------------------------------------------------------------------------------------------------------------------------------------------
--------??o---------BBBBBBB-----BB----------------------------------------------------------------------------------------------------------------------------------------------------------------------
--------------------------------------B-----------------------------------------------------------------------------------------------------------------------------------------------------------------
------------------------------------X-------------------------------------------------------------------------------------------------------------------------------------------------------------------
-------------------o-------B----BB-XX--X----------------------------------------------------------------------------------------------------------------------------------------------------------------
------X-----BB---?----------------XXX-XX---------------------------------------------------------------------------------------------------------------------------------------------------------------v
----------------?----------X-----XXXXXXX??????---------------------------------------------------------------------------------------------------------------------------------------------------------f
--------------------------------XXXXXXXX--o------------------------------------------------------------------------------------------------------------------------------------------------------------f
-------o--B--------------------XXXXXXXXX----?------------------------------------------------------------------------------------------------------------------------------------XX--------------------f
------B-----------------------XXXXXXXXXX----------------------------------------------------------------------------------------------------------------------------------X----------------------------f
--T--------------------------XXXXXXXXXXXX--------------------------------------------------------------------------------------------------------------------------------------------------------------f
--|-------------T---------o-XXXXXTXXXXXXXX------------------------------------------------------------------------------------------------------------------------------o------------------------------f
mX|XEXXE-EX-E--E|----------XXXXXX|XXXXXXXXX--------------------------------------------------------------------------------------------------------------BB-o-----??E????------E------EE---------------X
XX|XXXXXXXoX----|----XXXXXXXXXXXX|XXXXXXXXXX-------XXXXXXXXXXXXXXXXXXXXXXXXXXXXXXXXXXXXXXXXXXXXXXXXXXXXXXXXXXXXXXXXXXXXXXXXXXXXXXXXXXXXXXXXXXXXXXXXXXXXXXXXXXXXXXXXXXXXXXXXXXXXXXXXXXXXXBBBBXXXXXXXXXXXX
