------?------------?????------------------------------------------M---------BB--------------------XBXXX------------------------------------------??????----------BBMBB----------------------------------
-------------------------------------------------------------------------------------------------------------------B-----?---------------------------------X--------------------------------------------
--------B-----------------------------------------------------------------------------------------?---------------------------B----------------------BXXXX----------------------------------------------
--------------------------------------------------------------------------------------------X--------------------------------------------------oBBBB-----------------B---------B----------------------?-
-----------------?------------------X--------------------------------------------------------------M-----------------------------o----------XXXXXXX----X-------------------------------B----------o-----
-----------------------------------XX-------------------------------------------------------------------------------------------B------------------------------------------------X----------------------
-----????-------------------------XXXX--------------------------------------------------------------------------o-------M----------M--?-------B---------------------------------XX-----M------------o?--
---------------------------------XXXX----------------------------------------------------------------------------------------o------------------X------------------------------XXX-------?---------XXXXv
-------------------?????--------XXXXX----------------------------------------------------------------------------B-----------?-----X------B---BXXBBBBB-?----------XXXXXXXX----XXXX---------------------f
---BBBBBB----------------X-----XXXXXX-------------------------------------------------------------------------------------------B-------------XXX----------------------------XXXXX---------------------f
------------------------------XXXXXXX--------------------------------------------------------------------------------------------BM----------XXXX---------------------------XXXXXX----------------?----f
-----------------------------XXXXXXXX-----------------------------------------------------------------------------------------?-X-----------TXXXX-------------X------------XXXXXXX------------XXX------f
-----------o---------T------XXXXXXXXX-----------------------------------------------------------------------------------------------XXXX---X|XXXX???TBX-------XX----------XXXXXXTX--------B------------f
---------------------|--???XXXXXXXXXX-------------------------------------------------------------------------------------?---------------XX|XXXX--X|-------T-XXX--------TXXXXXX|X---------------------f
mE---E-----E---------|----XXXXXXXXXXX-------------M--------------------------E------------E-M---------------------E--E------------E------XXX|XXXX-XX|----E--|MXXXX---E-EX|XXXXXX|X-------------E-------X
XXXXXX--XXXXXXXXXXXXX|XXXXXXXXXXXXXXXXXXXXXXXXXXXXXXXXXXXXXXXXXXXXXXXXXXXXoX?XXXXXXXXXXXXXXXXXXXXXXXX-X-oXX?XXXBBBBBXXXXXXXX----X-------XXXX|XXXXXXX|XX---?-|-XXXXXXXXXXX|XXXXXX|XXXXXXXXXXXXXXXXXXXXXXX
