--------------------------------------------------------------------------------------------------------------------------------------------------------------------------------------------------------
-BME-??M-E?-XMB-------?X-?Mo-oo-EX--E--oE-M--MB--X------?--??M-o-Xo----E-M-o--E-X-EMX--M-E---oM-X-M?---------B-BX-E?-M?E---M--?-?E--??MBo-E-X-XB-E-X---o-X--BoEBMMM?Mo---?-EE-----B--BBM?-o--ME-o?o--B--
-E|--E-T-ET--??-BE----B-o-oX--X-|-o-BXB---E-MM-----E-?XMEB-BEoBX-T?--XXTE-o-o-|M|---?-B-?-------?E-X--XMMMEBM-XoT--|---B-ME---EM-EM---MBXXXE---EX----XX-?-X--oBXM--??----MoB?--o--BoE--E|EX-X------M--B-
--oo--o--?M-XM---Mo---|--o-E--E-B-XE?EX?B-?E---BX?----M--?--M-M-o-|B-o-?o--o----o-?------E--E-o--EX---E|EE-o--?-M-XME---M-B---XB-EoM------o---?-T--o---o|-|oEX-----X-M-B-E--X-MXoMX-?-oo-??ET--X??MoEEM-
-XoXB-T-XT-o-o?X-XM---MMMB?X-M|-B--M--?X-B---?BX--o----o----X-?--oToEB-M-EEX-EX----E---M--E--?-XoT---?--?M-----MM-M?-X?o-E----|MX??M-o-MX--Bo-B--B?B--BXo--??M--EB-XE-Mo-|o-B---B-?---E-EBB-oMoB-BE--?T-
-oEXB?---M-M-MMX-E---o?XB---BM-M?BM--X?-X--Eo-?|X-?EM-MEEE--o-X-BM-Bo-B--B-----XE------|-X---?--ET?-EB--Mo---??-X?B--E-BX?-M-B-?--|M-oMXo--|-M|--|-|?EEo??EB-X--|-E-X--T---ooMX-?Bo-------E-XTT--EoBX?o-
-oT|E?-XE-B?-|BEoB????BM-?M------?|-BT|-XX-EE-X-B-?E--E?-XB---M??-----M-M-E-??E--?E--BM--oXXX--M----|E-XE|o-B?oX?-E-oE--B---?EE|o---o-X-oB-EMB-X-BMM-|T-o----MX-|-XXB--oM-?XTX---?oM-MB-B--o-M--?o---?o-
-T----MB-o?T--M--Bo-|M-X-T---B?-E-oMXoMBB-EXM-o?-X-T---|B|BM--E-X--o--|EE-|MX-E---M-?o?XXE--B?B-EM?-M-?B--Bo|--X--XM?---MEME-E-BBMEX--M--M-o-ooB--X|?E---BM??|oM?----MBMM----M--E-----B---?----o-M-oMXMv
-M?E-M?EE-o?-X---B--MBX|--?---?oE-?-oEBXXMT?--?Eo--X-oEoBX-o--oEM--?--?--o--B-E-?E-MM-Bo-T--E-o-X-?M--M-B-X--oE-Xo------|M-?-TB--|-oo-?B-Eo-Bo?|oM?M---o-o?o----EX?-o-o-B-BXMMoE----M--?EM-B-B--MMXET-of
---EX--M?X---M?B?B--------o?XMX-o?-?-|-o?oE-EB?|oE-X--TEo-M-oE--X-ETMXTBBB-XB?X-T?-MXM-|?X---?----EME-B--B-Xo||oEE---X-EM|-|-?XB---TMX-?EM-EXBo-MX-B----B?-M?XX--ET-XE|-?--M-M|E--oX-M-MXT?o-MBo--TXB-of
-X-EME--EM---|-X------?--ME--To?X|---B-MBM--X-X--o--B-?-o-E-XBM-|-o-X-Xo-|-Moo?ooX?-BB?-o|?BX---?oEB-oXX?M??-X-Bo-oX?TX--??-oMXE---BXX----B?X?|BM---E-M-EB-|XETX--oEMXB-EB-ToBB--M--X--TEM---Bo?--Bo-BBf
-?-M|M--E?---EEEBBM-M-M---|--EMoM--B?-o-??----X---E-??XE---?E--M--Eo|--M-B---XEBoM?--EEX-?-B-B--ET--EXX-TXBB?---T?-B-oo--E?--Too----TEB-MX-|-X-X--BE-ooB-T--?o---?EX-|EM-?-?XE-E-M?---XM?o-BoE--M-----Xf
-E?X-|-X|--XMoET-|TXMB--BBB-M---B---M-|-BMoooo-?-oTMEB-X?M-X---M---B-M-XE-------|?B-M-|---EMM--BXX-?BE-E?MM-o?----M-M-T--?--o?M-E-----E-|BMBMT---MBXXB-M---X|?---?-?B-M-MBXo--XoE--oB-?-MMX-TM--oX-EEEXf
----EE-|---?----X--M-M--MB-oo?M----B-o?-|MEB-?-?XMBoM-BEXE-|BM-oo---oTMXB?E--o--||?-M--EX-B|--?E----MX--T-M-B?E--?BM--EM?-E--o|EE-E--?X--X--|o-M-MXE--M?---oM----|B--o--E-B--?EM-B-?---Xo?M-X-?--|-|-BXf
m--X?---?-M----oo------o-|-oMX-M?-BM-B---M?o-MBMXTMoXoM|B|-|---o|-MBTE--XTE--|---oBMTM?-M-o-EMM--o-o-?-M-EE--o-MooM-XBX--E---o-------B-?--?-------MXEX--?---X?---E----M--oE-B-?M?X-T--?---B-T-|XX-----?X
XXXXXXXXXXXXXXXXXXXXXXXXXXXXXXXXXXXXXXXXXXXXXXXXXXXXXXXXXXXXXXXXXXXXXXXXXXXXXXXXXXXXXXXXXXXXXXXXXXXXXXXXXXXXXXXXXXXXXXXXXXXXXXXXXXXXXXXXXXXXXXXXXXXXXXXXXXXXXXXXXXXXXXXXXXXXXXXXXXXXXXXXXXXXXXXXXXXXXXXX
