----------------------------------------------------------B---------B-----------------------------------------------------------------------------------------------------------------------------------
-----------------------------B-----------------B----------------------------------------------------------------B-----------------------------------------------o---------------------B-----------------
----------------------------------------------------------o------------------------------------------------------------------------------------------o--------------------------------------------------
---------------------------------------------------------------------------B-------------------------------------------o--------------------------------------------------------------------------------
------------------------------------------B-----------------------B-o-------------------------------------------------------------------------------o-B-------------------------------------------------
------------------------------------------------------------------------------------------------------------------B---------------------------------------------o------------------------B--o-----------
--------B--------B---------------------------------------------------B------------B--------------------------o-------------B--------B-----B-----------B---------------B-----------------B-------------B-
------------------------------------------------------------------------------------------------------------B----------------------------------------------------------------B-------------------------v
-------------------------------B--------------------------------------------------B--------------------------------------------------------------------------------------------------------------------f
-------------------B----B--B------------------------------B---------------------------------------------------------B--------------------------------B-------------------------------------------------f
-------------------------------------------------------------------------------------------------------B-----------------------------------------------------------------------------------------------f
--------------B-------------------T-----M------------------------------T-B-------------T---------------B-----B----------T--------------T---------------------B--------------B-----B--M----------------?f
------T------T--------------------|-------?-----------------T----T-----|-------T-------|-------T--B-BT---------T----B---|--------------|-------------------------T-----------------------o-------------f
------|---X--|------T-------------|----------------------T--|----|-----|-------|-------|-------|-----|---------|--------|B--o----------|---------T---T----T------|--TB-------------T-------------------f
m-----|------|------|-------T-----|---T------------------|--|----|-----|------B|-------|---T---|----o|------T--|--------|---T----------|--------B|---|----|----X-|--|B-----T-------|------------T------X
XXXXXXXXXXXXXXXXXXXXXXXXXXXXXXXXXXXXXXXXXXXXXXXXXXXXXXXXXXXXXXXXXXXXXXXXXXXXXXXXXXXXXXXXXXXXXXXXXXXXXXXXXXXXXXXXXXXXXXXXXXXXXXXXXXXXXXXXXXXXXXXXXXXXXXXXXXXXXXXXXXXXXXXXXXXXXXXXXXXXXXXXXXXXXXXXXXXXXXXX
