--B-----------------------------------------------------o-----------------------------------------------------------------------------------------------------------------------------------------------
-B------------------------------------------o----B--------B---------------------------------------------------------------------------------------------------------------------------------------------
-----------------------------------------------------------------------------------------------------------------------------------o--------------------------------------------------------------------
--------------------B--------------------------o-------------------------------o-----------------------------------------------------------------------------------B-------------o---B------------------
----------------------------------------B----------------------B--------------------------------------------------------------------------------------------------------B-----------------------------B-
-----------------------------------B------B-------------------------------------B----o--B-------------------------------------------------------------------------B-----o----------B--------------------
-----B-------B------------------------------------o----------------------------------------------------------------------------B----------------B-----------------------------------o-------------------
----------------------------------------------------------------------o------------------------------------B-----------------B------------------------------------------B---------------B--------------v
--B--------------------------------------------------------------------------B--------------------------------------------------------------------------------------------------------------------B----f
-------B--------------------------------B-------------------------------------------B----------o-------------------B-------------------------------------------------------------------o---------------f
-----------------------------------------------------------------------------------------------------------------------------------------------------o-----------B-----o-----------------B-------------f
--B--------TB--T---T---------T-----------------T---T---------------T-----T--------------------------------------------T----B------------T------------------B----------------T--------------------------f
-B-------o-|---|---|---------|--T-------Mo-T---|-B-|-----T---------|-----|--------------------------o-----------------|-----------T-----|-----------------------------T--T--|-------T---------------B--f
-----B-----|---|---|---------|--|----T-----|---|---|-----|---------|-----|-----------------------T--------------------|-----------|-----|-------T-------X-------------|--|--|-------|------------------f
m----------|---|---|---------|--|----|-----|---|---|-----|-----T---|-----|----------T------T-----|----T--T-------T----|------T----|-----|-------|---T-----------------|--|--|-------|------------------X
XXXXXXXXXXXXXXXXXXXXXXXXXXXXXXXXXXXXXXXXXXXXXXXXXXXXXXXXXXXXXXXXXXXXXXXXXXXXXXXXXXXXXXXXXXXXXXXXXXXXXXXXXXXXXXXXXXXXXXXXXXXXXXXXXXXXXXXXXXXXXXXXXXXXXXXXXXXXXXXXXXXXXXXXXXXXXXXXXXXXXXXXXXXXXXXXXXXXXXXX
