-BTM-o-|EoEoTMETXEoTM-oo|TX|-ETM?B-M-oB-MoET|?Mo|MTMME|EBoXEEXT-M?oT|?|?EEoMMo?T?M-MX---|TBTBTT|-E|oM|oB?BBXooTMM?oX?M?BTMEBo|o-?TXTBX|oooEM-BTTTToTTX-EX-Eo-XTT||-MBMXMEXT-TXoTTXoE|B?TB-MoXX-o?--TBMXX
M-?E----?EB--?-|-M--X?-BXo-B?-|B?-X----?ET-oE-B-o---??-M---|?X--?-EM---X?oB----M--X-B-oM--E-|BM-?-M-B-o-E---E--??o-----TT--T-E----Eo--E-E-------XoB-----B---X-T-B---o-------X--o-----|--T-E--------MToME
T-ME-MBo---E--X---M-?X?---M----------B-B?--EME---o-ME---B-X-E?X--------M-M-------EM--------X---?---M-E?X--E--o--M----Eo--E---?--------EXX--M-M-o-M-----M---oX--M-E-M-ME-------B--E------------E------oX-
----B----E---M----B------?-----E?-?BMX?------XXE--EM-oB---ME----------------?-BE-E-o-----X---oBE-E--B--?--BE-BBo--M-ME-XX-o--oX--ME--XE-BE------B-----o---B--M------M-----------B---o--o--M----o---EM-?-
?----?---X--B--oB-XoE-B---BBX--o------?--B------------X------EE-X-E-?---?-M-B-X--X-B-o------?B--o--X-------?E------EE-X?----?--o-oB--X-o-M-----o---?-E---E--?----?---M--?-----B-----MX---M----o--------X
o-BMo-------XB------?--o---M-XoX?E-X--o------?---E----?XB--M?XB?M-X--o----B---MX----M-BBB-BX-o--o?-------M-o-X-------o-X-E---?-----------?-----Eo--ooBE-----M-o----E-------------M--E--E-------E--E-B--T
M-M----E-B-o-B---B?---B-?BE--X-?-?--?M---XB-E----------M-E--?-----B---?X-EXo--?----BEM---X---------------o---o------------BM----E----XM-M-----o-MMo---B-ooE------?--M--?----?EE--Xo?o---------Mo--B-Mo-X
BXB---?-X--------o---M?-------EE-----X--B--M--?-------E-o-EooXX--M?-----o----o---EB-?---MEXX--X-o-----?M?B------B--BB-------E?BE-EE?----E---B---X-?M----Bo-------X-ME-------MB--Xo-o-XEXME?------E-----v
?-?-?-o--------X-o------X-M-EB--M--X-?--XBo--o--X-----oM?Xo---?o-XE--oX----B--X----o----X----X---X---EBM----BEX----??----X-Moo-B-M?-B--o?-E--Xo-----B--B--o------?--BME-B?--MX-B---o--oX--X---X-o--B-EBX
TBo-----E---B----BEX-X-XE-----XM-E?-----------------B------X--------B-EB-M---M-E?--?-------o--------------Eo----------B?B-Eo?--?-?---?E--o----oM------B?-M-E---------M--E-o--B-?--------B-B--X--?E--M-?T
?-E-B---o---?MX------MBE--B-------M----?----X--?--o----?M-X---------?---B-----MMo-X-MXEE--o-------ME-------Eo-----X-B---------E----M---------E----XB----B--Mo---XME-?-----?---BM-E----E-?E-----XB--B--X-
X-------M-BEE----MEEX--M?--MB---M-M----------E-X?------M-B---------o---BX?--M?-X---X?--B---------E--EXoE--X--B-X-E--E---o---ME------o-----E--o------o-o---M--E-o?-B---M-?-----B-B?-?XXM-X------B??---XM?
E-E-oB-M-E?-?-B-----?--X--Eo-M-M--MB---EM-??M--B?---XB---E------?---ooM-M--?M--X---------?---BE-E------??----------o-M--?E-EXX--M----BE-EM--?XX?---BB----XXB---B------B----?----M-?-B?-----o------B-----
|-----oM-X--o-o-----oE-E---M-B-?-o-E---o--E--o--?---?-?-X?M---BoXX--M----M-B-E--M--M---o----?X-?E-XE--X-B---?----oX----------M----B-----M----X------??X--B?-----o---B?-X-o--?o?-o-----X--B--B-E----?---M
m-o--BX-----------B--B--X------B---EE---B-Mo---E---BM-B-B?X---E-M--E-BoB--XE----XME-XM--------oBB-B?---X-B-M---------M-?-X--Bo-----?---B-?--B?BE--B--o------M-----oX-X----B---?-----BB--X-o--X---M-oE--B
XXXXXXXXXXXXXXXXXXXXXXXXXXXXXXXXXXXXXXXXXXXXXXXXXXXXXXXXXXXXXXXXXXXXXXXXXXXXXXXXXXXXXXXXXXXXXXXXXXXXXXXXXXXXXXXXXXXXXXXXXXXXXXXXXXXXXXXXXXXXXXXXXXXXXXXXXXXXXXXXXXXXXXXXXXXXXXXXXXXXXXXXXXXXXXXXXXXXXXXX
