---------------------------------------------------------------------------------?------------------B---------------------------------------------------------------------------------------------------
----------------------------------------------------------------------------------------M---------------------------M----B-X-???M-------------------M---------------------------------------------------
--------M----------------------------X----------------------------------------------------------------???-------------------------M---------------------------------------------------------------------
------------o-------------------------------------------------------------------------------------------------------------------------------XXXXXXXX----------------------------------------------------
-------------------------------------BBBB--------------------------------------------------------------------------------------o-----------------o------------------------------------------------------
--???---------------------------------o---------------------------------------?--------------o----BBBBB-?-------?------------------------------------------o------------X-------------------------------
----------------------------------------------------------------------X-------------BBBBBBB-----------B-----------?---------BBBBBBBBBB------------------------------------------------------------------
----------B-------------------------------------?---------------------XX--------------------------------------------------------------------------o----------------------------------------------------v
-------------------------------------------------------------------BBBXXX---------o---M---B-----------B---o---o---------------------------------------------------------Bo-----------------------------f
----------------------------------------------------------------------XXXX----------------------X----------------------------------------------------?-------------------------------------------------f
----------------------------------------------------------------------XXXXX--B------------------XX?---------------------?????-------------XXXX---------------------------------------------------------f
----------------------------------------M-----------------------------XXXXXX-X--------X---------XXX---------------------o----------?-----------T---------T------?------------------------?---------T---f
-------------------------------------------------------------------T--XXXXXXX---------T---------XXXX---------B---------XB----------------------|---------|-----o-----------------------------------|---f
-------------------------------------------------------------------|--XXXXTXXX--?-----|BBBBBBB--XXXXXM----------o-----XX------------------o----|---------|--------------?--------------------BBBBB-|---f
m-------------------------------------------------E----------E-----|E-XXXX|XXXXBB-----|--------EXXXXXXE------E?E-----XXXEBBB------E---E----E---|---E?----|---------o----E----E---------------------|---X
XXXBBB?------XXXXXXXXXXXXXXXXXXXXXXXXXXXXXXXXXXXXXXXX--------XXXXXX|XXXXXX|XXXXXXXXXXX|XXXXXXXXXXXXXXXX---X-XXXXXXXXXXXX----XXX--------------X-|----XXXXX|XXXXXXXXXXXXXXXXXXXXX----XXXXXXXXXXXXXXXX|XXXX
