-------------X-o-------M-------------------------------------------------o-----------------------------------------------------------------------------------------------------------------------BBBBBB-
------------BX?????------------------------M-------------M------------------------------------------o---------------------------------------------------------------------------------------------------
----------BBBBBB----------------------------------------------------------------------------------------------------------------------------------------------------B-----------------------------------
------BBBBBBB-------BB?BB????????---------------------------------------M-------------------------------------------------------------------------------------------------------------------------------
------------o--Xo------------------------------------------------------------------------------B-------------------------------------------------------------------?---------------------B--------------
-------------------------------------------------------------------------X---M-----------------------------------------------------------------------------------------------------????-----------------
------------------------------------------------------------------------XX---M-----------------------------------------------------------------B----X-----------------------------------X---------------
------X----XBB-?-?-----X--------------------------------------XXX------XXX--------------------o----------------------------------------------------XX----------------------------------XX--------------v
----------------?-----XX----------------------------------------------XXXX------M------------X-----------------------------------------------o----XXX---------------------------------XXX?????---------f
-------------B-------XXX---------------------------------------------XXXXX-----------------------------------------------------------------------XXXX--------------------------------XXXXX-------------f
----------B---------XXXX--------------------------------------o-----XXXXXX----------------------------------------------------------------------XXXXX-------------------------------XXXXX--------------f
----------X--------XXXXX-------------------------------------------XXXXXXX----------------------------T----------------------------------------XXXXXX------------------------------XXXXXX--------------f
------o--XX??T??-XXXXXXX------------------------------------------XXXXXXXX----------?-----------------|---------------------------------------XXXXXXX-----------------------------XXXXXXX--------------f
--------XXX--|--TXXXXXXX---------------------------B---X---------XXXXXXXXX----------------------------|--------------------------------------XXXXXXXX----------------------------XXXXXXXX--------------f
m-----EXXXX--|-E|XXXXXXX-------------------------------------?--XXXXXXXXXX-E-X-----------E------------|-------------------------------------XXXXXXXXX---------------------------XXXXXXXXX-----E---E--E-X
XXXXXXXXXXXBB|-X|XXXXXXX----XXXXXXXXXXXXXXXXXXXXXXXXXXXX-XXXXXXXXXXXXXXXXXXXXXXXXXXXXXXXXXXXXXMXXXXXXX|XXXXXXXXXX-XXXXXXXXXXXXXXXXXXXXXXXXXXXXXXXXXXXXXXXXXXXXXXXX----XXXXXXXXXXXXXXXXXXXBBBX--XXXXXXXXX
