----------------------------------------BBBB---------------------------------------?--------------------------------------oX---------------------------------------------------o----------o----?--------
-------o---------------------------------------------------------------------------------------------------------------X--------------------------------------------------------o-----------------------
----------------------------------------------------------------------------B-------------------------------------------------------------------------------------------B---B-----?---------------------
-----------------------B----------------------------------------------------------------------------------------------------------------------------------XXX-------------------------------------------
-------------------------------------------------------------------X-----------------------------B-----------------------------------------------------------------------------------------------XXXXXX-
-----------------------------B-o----------------------------------XX----------XXXXX----------------------------------------------------------------------------------------------------------M----------
-----------------------------------------------------------------XXX------------------------------------------------------------------------------------------B--------------BBBBoBB----------------BBB-
-------------------------------------------------------o--------XXXX----------------------------o-------------------------------------------------------------------------o----------------------------v
---------------------------------------B-----M-----------------XXXXXXXXXX-----------------------------------------------------------------------------------------------------------????????-----M-????f
--------------------------------------------------------------XXXXXX--B--------------------------------------------------------------------------------------------------------------------------------f
--------------------------------------------?----------------XXXXXXX-----------------------------------------------------------------------------------------------------------------------------------f
------------------------------------------------------------XXXXXXXX-----------------------------------------------?----------------------------------------------------------------------------T--????f
-----------------------------------------------------------XXXXXXXXX---------------------------------------------------------------------------------------------------X----------?-------------|------f
----------------------------------------------------------XXXXXXXXXX--------------------------------------------------------X----------X------------------------------XX--------o---------------|----TTf
m--------------------------------------------E--EE-------XXXXXXXXXXX----------------------------E---------------------------XX------E--XX------------E-----E---------XXX--------------EE---E---E|---M||X
XXXXXXXXXXXXX-----XXXXXXXXXXXXXXXXXXXXXXXXXXXXXXXXXXXXXXXXXXXXXXXXXXXXXX?XXXXXXXXXXXXXXXXXXXMXXXXXXXXXXXX--------XXXXX---XXXXXXXXXXXXX-XXXXXXXXXX----XXXXXXXX-XXXXX-XXXXXXXXXXXXXXXXXXXXXXXXXXXX|----||X
