--------------------------------------------------------------------------------------------------------------------------------------------------------------------------------------------------------
--XM-E--B---BXMM-X?--oM-oM----o--oB-?oB-oE-E---?---o--ooME--?-BX-----E--o---E-X-----?--E--o-E--?---M-?X-------M-E---M----BE-M?--------E---?----B-?X----?---M-oE---E---------M?--BM--XoMB---M-X-----XMXB-
--M-M---?-----o--Bo---M-?XXMB--?---??MX?E--ooB-o--?MoXEBo--M--E--M-X-oXXM--?-----EM-XB--------B--X---E--ooo-M-XX---oMM-------M-o-oEME?-E-oM-M-o---EMB--MM-?--XXX-o--Mo-ME?---EM--o-E-B-oMoMM------?MXo--
-??---------o?-M-MM----X-X--o--o---X--E?-XXM?M--M-X-?-----Moo-------o-o-Mo----MX?---o?---EM-E--?---M--XBE----oBo-o----?-?-EMB-X----EB---MB-o--M----E-?---?-------B-----X--B--------MB--E------o--?M---o-
-----X-BB-oX----M--B----EX-B-------o------M-----EM--o?--oMX-X--X--o----E-BEXo---E-o----?-----EXXE-E-M-BM-E-E--B-?-------EE?----------B--M-XM-----oE--oB-B-o--?--M---?-B-?B-?-MX-oB-EX---E---MB--M-------
-ooXE-BXXE----BM---M---?---M--EMB--E--BBB-XX--XBMB-MoM--?-?-MM--M--?-----------o-o-o---oo-X---M--o-oo---EXBM-E-XE--M--oE-X-MBM--E?--o-M-EMo?-X---------?--B---E---E-?E-oB---M--MX-----EM-XEB?ME-?--?X?--
-M?BM?--E-MX---M---M--Mo--?--X---M--BM-------oo--M----E--o--E?--?EM-E--X?-----M?XB-----M--X---EE------B-XEM---EM---X--B--?B-X---o--?--o?BX----M-E----?----------EM-------MM--E----?BM-X-o--E----B---M---
---M-M--Bo--X-oBXX---MM---M---Xo-----M--E-o-?oo-?--E--?Mo-M?B---------o--oM?-?-o-o----E-?---EBBoo?-oE--B?-------X---B-o---B----M-?M--E--EM---B-?B?oXBMM-o--M-M-------E--oXEEo-X--?EE-E-EEE-o---X-X-MM-?v
-Bo-M--M-BB---Mo-EEE-M?E--E--Xo--E----EEX--oB--E--E-E-o--oE-M?-M-----B-oo?EBX?--M---o-o-------E-M-o-o-B--B-?------o--M-BE--X-B-M-?o-?-----?EM?--E?oo------X-o--o-M-B-M--M----M-?--o----M?M--X--EE-Xo--Bf
-?--?o-?B-?--E--?-----M---?oM--MEBX-E-M-?-?X--M?M--E-------B-X-----EM---X---Xo--oEM---X--MX-----X-----M-----XM--E-o---------M------X-----?-o--M--EoB--oMoX--M-----?X-B?M----XE-EMoB----ooMMMB----X?--M?f
--o-M-oXMo--MXX--o----------MB?---E-------E--B--MoM------M--oEo------EM--oXX--MM--?XM-----X-oo---Bo---E-X------EBEXB--ME--o-M----M-oM-MMo---E?---E------BMX---------------------BM-X--EMo--E---Eo--MoBBf
----M---BX--B-M-----oBMM--B---------?-BE------oB--E---oXM-E-Mo-M---BBEE--ooM?----X---M-?MMo---EMB?-M---Mo---M---BBoB?-?---X-------X--BME-BME-E-----------o---E-EBM-BEM---?-Xo--M-B--B-----MB---BE---?M-f
---M---o-o?XE-?-MXM---?-o-B---E-o-M-X--B--B--oE--o--E--B--EoE---B--o-BXo-M--X----oBE---X--M--o-----M-o------E-BXM?MoM-o---E--X-X---E-??B--oo-ooX-?---M----X-M---?---MM---M--?---oB-E--?B?--X--BB--B---of
-?o-BoM--o--E-M?-?E-?MM-?Bo??--MME---B---BEM-o-E-------EM-XE-o--BM-E-?E?--o-?-Eo--o-B-?B--M-------B?o--------E-----Eo--BM-E--o?-E-?-------XBM-?Mo----M-?-MXoBM-?----o-?-oB-?o----?----XM--MB-XE-B?o--??f
m---XE-o--o-?--?--BM-E?-?o--Bo--MoEBX-Mo------E--?-o?-----X-M---?M-?X---M--o--oBBE-B?---??M---MX--E---B----o----?B-MoB--?--E--B-?X-----M--X---B-M-oM--o--E--E--?-oEE--M---o-----------BMo-?E-B-X-XB-EoBX
XXXXXXXXXXXXXXXXXXXXXXXXXXXXXXXXXXXXXXXXXXXXXXXXXXXXXXXXXXXXXXXXXXXXXXXXXXXXXXXXXXXXXXXXXXXXXXXXXXXXXXXXXXXXXXXXXXXXXXXXXXXXXXXXXXXXXXXXXXXXXXXXXXXXXXXXXXXXXXXXXXXXXXXXXXXXXXXXXXXXXXXXXXXXXXXXXXXXXXXX
