-BTM-o-|EoEoTMETXEoTM-oo|TX|-ETM?B-M-oB-MoET|?Mo|MTMME|EBoXEEXT-M?oT|?|?EEoMMo?T?M-MX---|TBTBTT|-E|oM|oB?BBXooTMM?oX?M?BTMEBo|o-?TXTBX|oooEM-BTTTToTTX-EX-Eo-XTT||-MBMXMEXT-TXoTTXoE|B?TB-MoXX-o?--TBMXX
M--E-?XE|?TTM-B-E?-X---X?|B-X--X--?-------|-----|E-||?MM?-E-----?-X?--|-?--o--oXM-E?M--E-M-M------B?--M-----?-M------o-oM----?---?-----|B--?X-?o?---E?----M-E-X-M?--X?-oE?|----TT-XB--------B|-----o--ME
TBB-?--??E---BX-o---?-------E----B---BEB---o---E--B|-?--E--B----o-----o--?E-?-??-o----o--M-E-M--?XX-?----------E--?--?BoXE----E------B---ME-?----?---E---Eo--BXM-?---?o-M--X--B--?-EM--E-o--B----E-M----
--Xo--E--o--------B-M-B-EE?-E?----X--B-oo---oo-----M-----X--E-?MM-X--E-----?E-?-----E---?--B--X----X--BE-BB-XM-X-o--E-o-?-M--X-oX--o---Mo-X-E-XX-o-------BX--E---M?-?B---------?oX--?--E--M--X---E--M-B-
?-M-X-oo-M--------?M-X--X---Xo-o-oM-?B----?-----o--M?o-Eo----oE---M-X-M---?----B--M-E?-E----o--X-----MM?--Xo-o-o---M-M-?--M-?--oM----?---------B?-E---XMoEX--?---?X--------MM--?E-------M------oE---o--X
o-MEEB-?-----B-B-----X--B-M--M-----?---------E---ooo--?--E?X?---E-ME-M--?--?MB---EM-----X-o-------?---o----E----E----MEX--X--M--X------MoM-E---E-E-E-E-----o------BB--M----X--------X-----?----------?-T
M-X-----B?-o-E----oB---X-?E?X--oME?---X---B-B---o-?-------o-------ME---BEMX-----B--?----M-oE----M-EBMX-Bo-E-XM----E-X------BEo--M-X--EB----------?-X-B-?------E----------M--B------o-??-MEo----o---BM-?X
B----B--?X-E-o-MX-X-----B-o--o-M------Eo---M-M-------M---M-----------o-X---o--XoX--MX--B---BXo-B-----o--X---E?B-E--E-ME--o-o--BB---------E-?-B---E?B-------E---------o-X--------?--B-E-X--------B--?---v
?-E----E?-X--o----X-B-?---E?----EEB----EMBo--?--XE-B---?--X-X-B-M----MB-?-B--o--B----?-M-X----XX?X-o--M----BME--X--E?--o---MB-?----------B------?E--E------BM?-M-?--?X-E------X-B-M-oM-XM---B--E-----oMX
T-Eo---XBB--X--------BM-M----M-------oB----B---BB------B----o--------Eo---B----E---??-?----X--ME----o------E-BX-?-o-----B-?--ME-ooMX-o--B-o------E-o-B--------MX-X-B---X-o------?-X-X-----?----E--E----T
?-----BX----oMM-ME-B-M-------B-o---?--M--------EMX-M--o?---E--?-B?X-M--o?--B--?X-XMo-?o-------X---M-X---B-Eo----------oEBX----------X----?-o-BM-------B----?-XE--B--X------X--B---o--oE--?X-----o---?-?-
X-----B-------B--B-E---oE--E-X----M?-??-M----o--?--B------BB-?E--M-E---?E---ME-E--X-?---E-oBM---EE?--X--o-------XM?--E-o---B---EBE?--oM---M-E--M-M--B----oE---Mo-MXooBMX--oo-E--?o----M-BMB-?--?-o-?M--?
E--M-B-EBB-M-EM----?----oo--oX----E---X-X----XEE-?---M------M-B-EEM--B-BE-----EM--X------X-ME--B---oB-E-----o--XX-o----o?-X--------X------B---X-EXB?B---?B-?--B--------X---X-?E-M-o-Bo--X----?-o?-B--MB-
|--------X--B--X--MXo-M---MX-------E--BBX--o-o----BB---XX-oo--ooX-M--B--B----Moo-o-?---o-------?---E-B-X--o--?XE-X------ooB---?--X----X?---B-o-M----X?--Eo-B-o?---XX?--?---?----oE-?-E---?--o-EBB-Mo---M
m-o-------XX------?B-B--?B?------X---M----M---------B----?-BBo----oB-M-E-----E-----X-MEo---M-B--B-BM-X-----o-XB-----M--?-?o---?---X--o--EXEo---E--M?-E-------B-?--o---EB-----------X-?M--BB--E-X----M-BB
XXXXXXXXXXXXXXXXXXXXXXXXXXXXXXXXXXXXXXXXXXXXXXXXXXXXXXXXXXXXXXXXXXXXXXXXXXXXXXXXXXXXXXXXXXXXXXXXXXXXXXXXXXXXXXXXXXXXXXXXXXXXXXXXXXXXXXXXXXXXXXXXXXXXXXXXXXXXXXXXXXXXXXXXXXXXXXXXXXXXXXXXXXXXXXXXXXXXXXXX
