--------------------------------------------------------------------------------------------------------------------------------------------------------------------------------------------------?-----
---------------------------B---------------------------------------------------------B---------------o---B------------------------------------------M---------------------------------------------------
---------------------------------------------------------------------------------------------------------------------------B------M------------------------------------M----------XX--------------------
--------------------------------------------------------------------------------------------------------------------------------------------------------------------------------------------------------
--------------------------------------------------------------------------------------------------------------------------------------------------------------------------------------B-----?-----------
-------------------B------------------------------------------------------------------------------------------------------------------------------------------------------------------------------------
------------------------------X---------------------------------------------------------------------------------------------BBBXBBB----------------------------------------------------------------B----
---o--------------------M--------------B--------------------------------------------------------------------------------------XX---------------------------------------????-----------------------?----v
----------------------------------X------------------------------------------------------------------------------------------XXX-----------------------------------------------------------------------f
-----------------------------B---XX--------------------------------------------------------------------------------------X--XXXX------------M------------------------o---------------------------------f
--------------------------------XXX------------------------------------------------------------------------X-------------XXXXXXX-----------------------------------------------------------??????------f
----------------------T---T???-XXXX-----MM----------------------------------------------------------------X--------------XXXXXXX-------------------------------------------------?---------------------f
--------------------T-|---|---XXXXX-----------------------------------------------------------------------XX-----------X-XXXXXXX--------------------------------------------------T--------------------f
----------------X---|-|---|--XXXXXX----------------------------------------------------------------X------XXX-----T---XXXXXXXXXX---------------------------------------------BBBB-|--------------------f
m---------------XX--|E|---|-XXXXXXXEE--------------------------------------------------E---E---------E----XXXX-E-E|--XXXXXXXXXXX-----------E---------------E----?--------E-----EE-|--------------------X
XXXXXXXXXXXXXXXXXXXX|X|---|XXXXXXXX-XXXXX-------XXXXXXXXXXXXXXXXXXXXXXXXXXXXXXXXXXXXXXXXXXXXXXXXXXXXXXXXXXXXXXXXXX|XXXXXXXXXXXXXXXXXXXXXXXXXXXXXXXXXXXXXXXXXXXXXXXXXXXXXXoXXXXX---|XXXXXXXXXXXXXXXXXXXXX
