--------------------------------------------------------------------------------------------------------------------------------------------------------------------------------------------------------
---o-------MX--M---XMo------XEoX----X--------M?--oo-E------XMBB--MB---E?------?-B----M---XXX-?---o---?X-ME-MM---E-B----?--MEME---o-------oE-----M-?--EM---------M---o--o----E----oX--??---X-o---BXX-E---
----o---?X---------o---E--?X---oo?E--X----E----?-----B--X-M-----oo-o---EX----M-oT----o-----BBE-MX--X-M----M--MBoB----XM----E-B-----Moo-BE?B--------XX-M-E-EE-E------T---MX--?X--MMM--?---E-o?---?B-MEM--
-XX-oM--X--XE-------B--?---?X-M--X-----X-----X--M-------o-?o---------MB?o--Bo-?-M----B-MX?--o------M--ME?-----oE---X-MBXX-MB--o---M--M-E-----B-o----B--XEM|-MEE?----B?-B-?B---X---EX-o--------X-|-o-MB--
---X?--MBE-o----X--E-E-?--X------E?EB----B?--MX-?----B-MBM----?---BX---E-E------------B--o-XBX-?---B--EX---M--?-X-------BM-----E---?E--B-EBEE-XE------BX-B--M---?--M-|E-E?---B---?---E----X?XB---X-?-XE-
-Bo-o-E--B--o------?--------MMoo----X--B------X---MX-Xo---oEE--MM-E--BB-----B---??-----EXX----E??--?B-M------XE----------?-E---?-M---?Xo-ME-X-----BBE--B--?E-X--B--M-----TMM----X-EB------oE-?-------X--
-M---B-o---EX----o-B-MX-----B---E--M-E----MBE-------------?-M?-?-MM--E-------X-------------B?--M?M--BM---B-o--X---M-X------X--XM-o---BE---oMM-B-B?---?-B-o?--------E--X---------E----E----M-E---------E-
-BE-M?-?---M---MBEMX--o-------o--Eo?M-X-?-B-BB------XX--M-T----?---MM-?M----o----o--XEB--EM--X--Mo--M?-E-o-o-----M--XBMB--X----o---X-----X---EMM??M-M------?------XM--?-o?--M------------X-M---o--M-M-Ev
-BXo--X--------?--X---T----?------X-?--BX--?---B-?-E-M---MX-EEX-o-----BX---BX--?-?-?--BMoo---MX-BXMXE--MB-----------X-M-M--X--E-B-----M?-E-?-o-o|---BB--?-XT-oX-----?E-----B-B--BE-E-----E-EEo---?--oMof
--BB-X------B-?BE?------M--o-X--E?B---X---E?-B?-?-X--E---M?-----T-B-------X---------X--|T-------o-M-----------X-----X-o---MX-X-------X-M-o?M--M?----B-----XMo--BXo--B---?----oE-M-----M-?o-T-M-oo--EXM-f
-----BEB-o---o----E------B?o---X--MEM--oBo-MXE-X--???--?-X--------B-o?-B-?--o-??--E----|---?--?XoX--o---EX?ME--X--XB-?-----BEM---B--?---o??------EX------??E---o-X-B---XE--M---XM--o------B--o---E--E-of
--M--|---X-o---------E-?---B------o?B-?---o-M-o---X--------M-o--Eo-M------M----o-oB---?--BMX------EME----------MB-M--M-----B---?---M-X----X-B----E?X--M-o|-----?--XB--------o--??-M------------EX-----Xf
---M--B-B---?o--?-----M?MB-B------X-------X-----?MM------M-Mo---?-BXB---E-MX-o--------B----M-M-B---B-BE-M---E-?-B-----------E-XM-----B-MXE-E--B-o--??Xo-X-X-----B-----oEXX?-?-XM?X--BMX-----E---?--o--Bf
-X-o---B----X--EMo--oEB------o-BBo---XMo-------oXo-X----M-----?----??-XB-----M-----B------E-X?--??-X?----o-o----B----XM------M--o--o----MMoE--X-BE----EEMM-o-oBMB-E----o-X--o-Bo-----X-M-B--B?BE?M-----f
m------MX--?-EE---M----Xo---MXBB-E--?-B-E---B--B?--E-B-?B-EB--X--M--T---o-o-------o-EX------E----B--?-?o--?------?-M-XM-----oX-?----?-?o------------E-EoX---B--?--X--M------B-o-?-o?-T-XM-----?--M-B-BBX
XXXXXXXXXXXXXXXXXXXXXXXXXXXXXXXXXXXXXXXXXXXXXXXXXXXXXXXXXXXXXXXXXXXXXXXXXXXXXXXXXXXXXXXXXXXXXXXXXXXXXXXXXXXXXXXXXXXXXXXXXXXXXXXXXXXXXXXXXXXXXXXXXXXXXXXXXXXXXXXXXXXXXXXXXXXXXXXXXXXXXXXXXXXXXXXXXXXXXXXX
