-------------------------------------------------------------------------------------------------------------------???????---------------------------------------X--------------------------------------
-------------------M------------------------------------------------------------------------------------------------------------------------------------------------------------------------------------
--------------------------------------------------------------------------------------------------------------------------------------------------------------------------------------------------------
--------------------------------------------------------------------------------------------------------------------------------------------------------------------------------------------------------
--------------------------------------------------------------------------------------------------------------------------------------------------------------------------------------------------------
--------X----------------------------------------------------------------------------------------------------------------------------------------------------------------------------------------M------
------------------------------------------------------------------------------------------------------------------------------------------------o-------------------------------------------------------
---------------------------------------------------------------------------------------------------------------------------------------------------------------?---------------------------------------v
-------------------------------------------------------------------------------------------------------------------------------------------------------------------------------------------------------f
-------------------------------------------------------------------------------------------------------------------------------------------------------------------------------------------------------f
--------------------------------------------------------------------------------------------------X----------------------------------------------------------------------------------------------------f
--------------B---------------------------------------------------------------------------------------------------------------------------------------T------------------------------------------------f
------------------------------------------------------------------------------------------------------------------------------------------------------|------------------------------------------------f
---------o---------------------------------------------------------------------------------------------------------------X----------------------------|-------------------------------------X----------f
m------------------E----------------------------------------------------------------------------------------------------------------------------------|-------------------------------E----XX----------X
XXXXXXXXXBXXXXXXXXXXXXXXXXXXXXXXXXXXXXXXXXXXXXXXXXXXXXXXXXXXXXXXXXXXXXXXXXXXXXXXXXXXXXXXXXXXXXXXXXXXXXXXXXXXXXXXXXXXXXXXXXXXX?????XXXXXXX-------XXXXXX|XXXXXXXXXXXXXXXXXXXXXXXX-----XXXXXXXXXXXXXXXXXXXX
