-BTM-o-|EoEoTMETXEoTM-oo|TX|-ETM?B-M-oB-MoET|?Mo|MTMME|EBoXEEXT-M?oT|?|?EEoMMo?T?M-MX---|TBTBTT|-E|oM|oB?BBXooTMM?oX?M?BTMEBo|o-?TXTBX|oooEM-BTTTToTTX-EX-Eo-XTT||-MBMXMEXT-TXoTTXoE|B?TB-MoXX-o?--TBMXX
M-?-E---B?X--?----|-|M-|-o-BX--?-?X---M-----E-BM-----?-MoEE?o-o-B-EMM----oXT-E--?---B-BMB---BBM-??---B?-E-E--o-?-o-?--MT-|-E---o-X-M--Eo--M---E-?-M-----T-oX-B--X---X-------M---|----|--?--EB--MoM-?--oE
T-Xo?-BoM-------B-M??--B-----X---------oB?--M----o-?----o---X--Bo-o----M-E-----E-E-M---M--------X--E-X?X--E--o-------EoXB-MX-?----?--B-X--M-XX--Bo--M--M-X-----?X?---M?--M----Mo-E-E---------E-?E-o-----
--X-Bo-------M--X--oX-B-B-?E---EX-?--X?---X--XXB-B-M--o?E-M--oo--oX-----X-M-??Bo---E-o--X---oB--o------MEB-E------M--E------o-XEX-?--XE---X-----B-----o---------o---M-E----B-o------??---------o--E-M-?-
?-M-----BX--B--oo-o-XX-----BX--o---X----Bo?--?---o----X---B-------X-------M---XBX?-B--?-----X------o--M--M-ME------E---?----BB?-?--M?X-o-M---B-o--M?-E----?-E----?-------X----M-?-------------oE----BB-X
o--?oB?---?---oBo------oo---EXoX-------------?---E---M?X-----X--B-X-------BMX-MX------X-B--X-oX-o--E----EM---X--E----o-----o-?-----------MB---BEo---o-E----M-MM----E-----?----------E---EM-------?o----T
MX-?EE-E-XMM-B--o-o---------?----?-o?---?-B----E---?---B-EX-?--X--B------E-----------?--MB-E----X-E-------M--o-?-MM----E--B--X-----o-B?-----oEXM-?----E--oE?--?B-?-EM-----E-------o?----M-?----X---MMM-X
BXB-M---X-?E---o-o?-Mo?---X--o---o-----MBX?MM-?----?--E---E--??--M?----M-?-o-o---E-------E--X-X-------?E?-----B----BEM--?--B--BE--E-EEE?-o--BB-EX-?M---BBM-----------?--?---M----o------ME?--------M---v
?-?-?-o--------o--Xo------M-----M--X-?-?---------??E--o--XX-----M-E------o--------X--X--XB--X-XE-?M--E------X-X-B---?----MBMBoE---?o-X-??----?---M--X-EBE---X--?----BME-BoE-MB-----o-B-X---E---B--E--EEX
T-o----XX--oBX-E--EXE----------MMEB-------B-?---------E---B---XXE-----EMMM-M---E---------------X----oo----?o---MM-X-----B-E---?-X-MM----M--M-X--?------?-----XB---MB-E---oo----?o---MoMMB--?-XXE-?-MME?T
?--XBE-X-X--X--------?--E---------X----X----E?--X-----o?--M-----MEMM----B-X---MXoBM--X----o------B-B-------Eo-------oM--B-XE--M----M----o----?--E-XBM-BB---M------E-----------B-EE--o---M-M--X------E-?-
X---------BE---B-M-EXo-X?--EM-------E--XM--M-M------------X-Mo-----o---BX?-BM?M-E--??--Xoo?--X--XE-----E-X-E-----EB-M--------?-X-X-B?-----?--o--------?---B?-XEX?-oo--Bo-XXE--X----XXX--XB---X--?ME?--M?
E---X--B--XMM-B----o----------------E---M-??---E-?-----------?--??---o------?--E?--E---??-B--?E-X-----BM----?BX-E----X--?--XM-X-M-oB----B--??B--M-oBB-X---oEX---E--?B------X-?-M-----M-E--B---BXEB------
|E---MoM--E---E--------E---MBB---B-B----B----?B-------?EB----B-oB-MB----BE---?oo--M-M--------XB------B-?------------X-------E--?-XB--E-?B------B----E?Xo-----o-o-M---?---o--B??-o-B---B-----B?-----?--?M
m-o---XB------?-----XB---B---B-MXX---M--B-XX--EE------X---XB--MB-XBE----?-XE------E------o-B?--BB-BMM--X-------Eo----B--E?--X------?--M?-?--XM-E--B-X-o---B-X--------X-EB--M---?-----BM-?-o--------?---B
XXXXXXXXXXXXXXXXXXXXXXXXXXXXXXXXXXXXXXXXXXXXXXXXXXXXXXXXXXXXXXXXXXXXXXXXXXXXXXXXXXXXXXXXXXXXXXXXXXXXXXXXXXXXXXXXXXXXXXXXXXXXXXXXXXXXXXXXXXXXXXXXXXXXXXXXXXXXXXXXXXXXXXXXXXXXXXXXXXXXXXXXXXXXXXXXXXXXXXXX
