--------------------------------------------------------------------------------------------------------------------------------------------------------------------------------------------------------
-M?-----E-B-MME----Eo-BB-M---?---MM--X--E---------B--?---X---X---E--B-Mo-o-------XX-oo---B--X-o-E----M----E----B-ME?E--?------?Eoo--?--MB---MMB------M--oB?-BBo---X-----o---XM-X-MoM---o-MB----B-X-B-??-
---o---o--X?B-?----M?o---E---X-o----------?-o-E?-M---M-------X-o-B---------ME---X-----?-?-X----B----?----o---o-Xo--E-M--?o---E?----?--BB----M--?-B-----M-?--E-B--------X--?-BEBoX-M???-B?M----X-?-?--?--
---M-----ooE--X-??------??---BM---o-E-----X-E----------M--B--oB-X?o--o----EXX-M------E-M--B---M?-----MBXE---B-MXX?-M--oX----M--X-?----EM--B-E------BX-?--E---oE-M--M--M--?--XXBM--MX-oo--X---EEoX-X--oE-
--o---M---XE----?--M--oBM--M-----------------B--------?---oEX----Bo-------XB--B--------?-M-------o---EME--?-o-o?X-----B-M--X---XM----X-----?--------B-E----E--XoBE-o?---------E----M--o-E?--X--MMBBEXBM-
--E-o-?----BM?----------?XE-----------B------M---------E--oM---B?-X---X------MX-?M-B-----o-?---X----M?-X--Eo?-oE--BE?M----M---Mo-?B---------EXE-X-?-?---?-BMEo?-MXX-XB-E---X-o--X--?------oM-BoBB-------
-oB-B-B----T----B---Bo---X--M--M--X?-B--MEMo-X----?E?--M-E----------E----B?o---X--------X--|-X-M-BBX--X?B--X----??-B?-?-E-Xoo?--------o--X?---B-XEB--------M-o--MBM--------E-EX--E-BB---E--X--?--M-?X---
---M---E??o-BX-?X--Bo-E-B--o-o-XB-BX?-----X?M-MXM-E?------M--M?---M---o----M----XX-Xo-M-o------o--T-o--MMMB------BX------B---oBX----M----E-XEX?--XM---E---X-----E-X--?-BB-E-E---B-?M-ME----?EE-----XXM-v
-----------X--?-?E-o?-B--ooE?oBM-X---o-?--ooE--X--XX?E-E-E--?-?-------?--M--X------E-----------X-MoX-MX-oB--BE-X?o-------X-E--o-M-?--B-X-o?-EoM--?-----?---------BM-B--MEo------o--o-EEo--------X-----Mf
-B--E--Xoo--M--o--E--X------XB----X-?MM----?MXE---------?-----BEEo-----?-Bo---E--MMoo-------Boo-EB--o--?----oB-?---M--X-MXoo-EMX--EM?---M--B-X---?E--?--BE----o--TB----E--M---B---X--?-----B-----?---?-f
-?X------?-E----XM--B-oE----E--E-?M---X-----BM---M---X-E-----?-BX-M--o-EEE-o--B-o----?-X--?oX-M-oE-oM--B--?--E---EX--E-BME-B-B-oB--X-----E-?X?-----XXX-----B-E---BB--?B----M-----B----oM----Bo----M--XEf
-?X-B-B-------o-oB-E-X--M?MM-oB-------X-XEo--M--MMXMX?---?B-----B-X-B?------?X--ooX-?Mo---------M-X---?-MXB--BB---?-------M--?-E---X-o-X--M------X---oE----X--?-EE--X-oX--?E-o---o--E---M----B-o-B?ooE-f
--BB-?-MM------o-B-XE-M-EoB--?-?X----X-M---?---BB----X-Xo--o-B--X-?oo---o-----E--B---o----XX--oB|?--------M-----BE-X------E--B-----?---E-XE--X--?----Mo---oo--?oE--E---oX-----o--?E----M--X?E-----M?---f
-----X---?o-M-?-B---?-M-?B-oE---EXB-E-B-B-E---o---EBB?-------E---M-Moo?-BX-B-M--M-X?----M-B-X-E----------oX-oM-o--o-----?-----XB--M?-BEo----XM---M--B?-o-XE-----o-ME--X-oEM----oB--E-----oEoE---?M-?---f
m?-E--M-M-B----o--o--MB----o?EX?oM--B--E----B---?B--B--o-MoM---MMME?X-?E---B-E--X-X-XM-EM--B-----E--X--M--??-oX--?o-Mo----oE---o--Mo-EE--M-M-B--oEE----------o--E?E?-----MX?--E---M--X---M-X-?--MMX?XX-X
XXXXXXXXXXXXXXXXXXXXXXXXXXXXXXXXXXXXXXXXXXXXXXXXXXXXXXXXXXXXXXXXXXXXXXXXXXXXXXXXXXXXXXXXXXXXXXXXXXXXXXXXXXXXXXXXXXXXXXXXXXXXXXXXXXXXXXXXXXXXXXXXXXXXXXXXXXXXXXXXXXXXXXXXXXXXXXXXXXXXXXXXXXXXXXXXXXXXXXXX
