-----------------------------------------------------------------------------------------------------------BBB---------------X-----------------------------------------X------------------------X-------
---?-------------------------------------------------------------------------------------------------------------XXXXXXX------------------------------------------X-------------------------------------
---------------------------------------------------------------------------------------------------------------------------------------------X--------------------------------o-------------------------
---------------------------------------------------------------------------------------------------------------------------B------------X---------------------------------------------------------------
--------------------------------------------------------------------------------o----------------B--------------?-????X???---------o--------------------------------------------------------------------
-----------------------------B-o------------------------------------------------------------------------------?------XX---------------------------------------------------------------------------------
-------?---------o-------------------------------------------------------------------XXXX---------------------------XXX----------------------------------------------------------o--------------o-------
----------------------------------------------------------------------------------------------X-----------o--------XXXX--------------------------------------------------------------------------------v
---------------------------------------------------------------------------------------------XX----------------?--XXXXX-----?-M-o----------------------------------------------------------------------f
-----------------------------o--------------------------------------------------------------XXX------------------XXXXXX-----------------------------??????-----------------BBBBB-----------------------f
------------------------------------------------XX-----------------------------------------XXXX-----------------XXXXXXX------------------XXX------------------?-o-------XXXX---------------------------f
---------------------TT----XXX--------------------------------XXXXXX----------------------XXXXX----X-----------XXXXXXXX---------X---------------------------------------------------X-----------------Xf
---------------------||------------------------------------------------------------------XXXXXX---XX-----B----XXXXXXXXXB--------XX-------------------------------------------------XX-----------------Xf
---------------------||-----------------------------------------------------------------XXXXXXX--XXX---------XXXXXXXXXX---------XXX--------------------------------------??????X--XXX--T--o----BB----XXf
m--------------------||--------E-----------E------------EM----------------------E---X--XXXXXXXX-XXXX----E---XXXXXXXXXXX----?????XXXX-----X------E----Eo-------E-----E---E----E---XXXX-o|------------XXXX
XXXXXXXXXXXXXXXXXXXXX||XXXXXXXXXXXXXXXXXXXXXXXXXXXXXXBXXXXXXXXXXXXXXXXXXXXXXXXXXXXXXXXXXXXXXXXXXXXXXBBBXXXXXXXXXXXXXXXXXXXXXBBBBXXXXX---XXXXXXXXX--------XXXXXX------XXXXXXXXXX-XXXXXXX|-------XXXXXXXXX
