----------------------------------------------------------------------------BB---------------------B------------------------o--------------------??????----------BBBBB--------------------X-------------
--------------------------------------------------------------------------------?????-XXXXXX-----------------------B--------------------------------------------------------------o--------------X------
----------------------------------------------------BBBBBBB-------------------------o------o--------XB------------------------------------?-----------XXXX----------------------------------------------
-----------------------------------------------------------------------------------------------------------------------------------------------o---------------------B----------------------------------
--------------------------------------------------------------------------------------------------------------------------------------------------------------------------------------------------o-----
--------------------------------------------------------------------------------------------------------------------------------B------------------------------------------------X----------------------
------------X---------------------------------------------------------------------------------------------------M-------M----------------------------B--------------------------XX-----M----------------
-----------------------------------------------------------------------------?------------------------------------------------X------------------------------------------------XXX-----o------------XXXv
--------------------------------------------------BBBBBB----------------------------------------------------?X---------------?-----X----------BBBBBBBB------------XXXXXXXX----XXXX---------------------f
---------------------------------------------------------------------------?-----------------------------B-------------------------------------------------------------------XXXXX--X---B--------------f
---------------------------------------------------------------------------------------------------------B---?---BBBBBBBB---------------------------------------------------XXXXXX--M------------------f
------------------------------------------------------------------o------------------------T------?--TT-X------------------o----X------------------------------------------XXXXXTX---------------------f
-----------o-----------------------------------M--------------------------BBBBBB-----------|-o-------||-XX-----BBBBBB----------------------------???-T---------o----------XXXXXX|X---------------------f
------------------X--------------------------------------B------------------------------o--|---------||-XXX----------????-?--X--------------------BBB|BBB-------------X--TXXXXXX|X??-------------------f
m-------------E-----------------E-----B---------------------E-----------------------------E|---------||-XXXX--E---E---------EXX--------ME------------|----------o----EXXX|XXXXXX|X----E----E-----------X
XXXXXXXXXXXX----XXXXXXXXXXXXXXXXXXXXXXXXXXXXXXXXXXXX------XXXXXXXXXX---------XXXXXXXXXXXXX-|---XXXX--||-XXXXX---XX-------XXXXXXXXXXXXXXXXXXXXXXXMXXXX|X-----------XXXXXXX|XXXXXX|XXXXXXXXXXXXXXXXXXXXXXX
