-------------X-o-----?----------------------------------------------------------------------------M--------------------------o--------------------------------------------------------------------------
------------BX?o???----BBBBBB------------------------------------------------------------------------------------------?------------------------------------------------o-------------------------------
----------B--X---------------------M--------------------------------------------------------------------------------------------------------------------------------------------------------------------
--------------------BBBBBBB----------------------------------------------------X----------------------------?-------------------------------------------------------------------------------------------
------------o---o---------------------------------------------------------------------------------------------------------------------------------------------------------------------------------------
------------------------------------X----------X--------------------------------------------------------------------------------------------------------------------------------------------------------
-------------------X---------------XX---------XX------------------------------------------------------------------------------------o----------B--------------------------------------------------------
-----------XBB----X---------------XXX--------XXX---------------------------------o---------------------------------------------------------------------------------------------------------------------v
----------------?XX--------B-----XXXX-------XXXX--------------------------------M-----------------------------------------o------------------o--------------B------------------------------------------f
-------------B--XXX--B----------XXXXX------XXXXX-------------------------------------------------------------------------------------------------------------------------------------------------------f
----------B----XXXX------------XXXXXX-----XXXXXX------------------------------------------------------o---------------------------?-------?------o-------------------------------XX--------------------f
--------------TXXXX-----------XXXXXXXM---XXXXXXX---------------BBBB-------------------------------------------------------------------o-----?-----------------------------X----------------------------f
-------------X|XXXX----------XXXXXXXX---XXXXXXXT---------------------------------------------------------------------------------------o---------------------------------------------------------------f
------------XX|XTXX-------o-XXXXXXXXX--XXXXXXXX|--X---------------------------------------------------------------------------------------------------------------------o------------------------------f
m--------EEXXX|X|XX--------XXXXXXXXXX-XXXXXXXXX|--------------------E---E----------E------X-------------E------E-E--------------------------XX----------EBB-o------E-----------E------EE---------------X
XXXXXXXXXXXXXX|X|XXX-XXXXXXXXXXXXXXXXXXXXXXXXXX|XXXXXXXXXXXXXXX------------XXXXXXXXXXXXXXXXXXX---XXXBXXXXXXXXXXXXX--XXXXXXXXXXXXXXXXXXXXX------X---------X---XXXXXXXXXXXXXXXXXXXXXXXXXXXXXXXXXXXXXXXXXXX
