---B-------------------------------B-----------------------------------------------------------------------------------------------B--------------------------------------------------------------------
------------------------------------B----------------------------o------------------------o------------B------------B-----------------------------------------------------------------------------------
--------------B------------------------------------------------------------------------------------------------------------------------B----------------------------------------------------------------
--------------------------------------------------------------o----------B--------------------------------------------------------------------------B---------------------------------------------------
---------------B------------------B---------------------------------------------------------------oB-----------------------------------------------------B----------------------------------------------
----------------------------------B----------------------B-------------------------------B---------o--------B------------------------------o---------------------------------------------B--------B-----
-----------------------B-----------------B----------------------------BB-------------------------B----B-----------------------------------------------o-o----B------------------------------------------
---------------------------------------------------------------------------B-----------------------------------------------B--------------------------------------------------------B------------------v
----------------------------------------------------------------------------------B---B-------------------------------------B------B-------------------------------------------------------------------f
--------------------------------------------------------------------------B---------------------------------o------------------------------------------------------------------------------------------f
----------------------------------------B---------B------B--------------------------------------------------------------------------------------------------B------------------B------o----------------f
----------T-------T--------------o------------------------T------------------T-B-----------------------------T------------------------------M---M---T--B------T----------T-------------T------T--------f
----------|----M--|---------T----T-------B----------------|---------?--------|----------T-------------T------|--------T-----------T----------------B|---------|-------T--|-------------|------|--------f
----------|-------|---------|----|-----T--T---------------|--------------T---|----------|---T---------|---T--|--------|-----------|X-----T-o-T------|---------|---?---|--|---TX--------|------|--------f
m------o--|-------|---------|----|-----|--|-----T---------|--T----T------|---|-------T--|---|---X--X--|---|--|--o-----|-------T---|------|---|--oT-X|----T----|X-X----|--|---|---------|------|--------X
XXXXXXXXXXXXXXXXXXXXXXXXXXXXXXXXXXXXXXXXXXXXXXXXXXXXXXXXXXXXXXXXXXXXXXXXXXXXXXXXXXXXXXXXXXXXXXXXXXXXXXXXXXXXXXXXXXXXXXXXXXXXXXXXXXXXXXXXXXXXXXXXXXXXXXXXXXXXXXXXXXXXXXXXXXXXXXXXXXXXXXXXXXXXXXXXXXXXXXXX
