------B---------------B------------------------------------------B-------------------------B------------------------------------------------------B-----------------------------------------------------
-B-B---------B-----B------------o------------------o------------------------------------B-----------------------------------------------------B---------------------------------------------------------
--------------o----------------------------------------------------------------------------------------------B---------------B----B---------B--------------------------------------------B---------B----
-----------------------------B---------------------------------------------------------------------------B-----------------------------------------B----------------------------------------------------
-------------------o---------------B-----------------------------------B---------------------------------------------------------------------------------------------------------------o----------------
-------------------------------------------------B------------------------------------------o-----------------------------B------------------------------------B----------------------------------------
-----------o--------------B-----B--------------B----------------------------------------o---------------------o--------------------------------------------------B------oB--------B---------------------
--------------------------------------------------------------o------------------------------------------B----------------------------------------------------------------B----------B-----------------v
----------------------------------------B----------------------------------o------------------BB-------------B-------------------------------------------------------B---------o-----------------------f
--------B-------------------------------------------------o---------------?-------------------------B-----------------B------------------------o-------------------------------------------------------f
----B-----------------------------------------B-----------------------?--------------------------------BB-------------------B---o---------------------------B------------------------------------------f
-------------------------M-----?------------------------------------------T------T------------T--T--------------T-------B-------------------------------------------------T---------------T--B---------f
----------BB-----T---------------------------------T------T---------------|-B----|---T-----B--|--|---------T----|----B-------T--------------------------B-----T-----B-----|----T----------|---T--B-----f
------T----------|--------T--T---------------------|--T---|-B----X--T---?-|------|---|--------|--|----o----|----|------------|--T--T--------T--------o--------|-----------|---B|-------T--|---|--------f
m-----|-------TE-|E-------|--|--T---T---------T----|--|---|---------|-----|------|---|----T---|--|---------|----|----EB------|--|--|-----T--|-----------------|-----------|----|o-XT---|--|---|--------X
XXXXXXXXXXXXXXXXXXXXXXXXXXXXXXXXXXXXXXXXXXXXXXXXXXXXXXXXXXXXXXXXXXXXXXXXXXXXXXXXXXXXXXXXXXXXXXXXXXXXXXXXXXXXXXXXXXXXXXXXXXXXXXXXXXXXXXXXXXXXXXXXXXXXXXXXXXXXXXXXXXXXXXXXXXXXXXXXXXXXXXXXXXXXXXXXXXXXXXXX
