--------------------------------------------------------------------------------------------------------------------------------------------------------------------------------------------------------
-oXM---EB---X-M-B---Xo---ME--M--XoE---o-?--M--B--XM-E-?-M--M-X--ME---E----M---M-----Eo-E-M-X-B--M--B--M-BMB---MB-----B----EBM?o--M--E-----------E-o--M-B---?-BEX--E--E------MM-B-M---?MB-----B---EEXX?B-
-X-MMo-------------X--M-?--MB-oE-E---MX----?-oMoX-M-?M--E-----?E---X-M-XM---B?E-MMM------E--EB--EM-?o--EE----------o--?--E---M-?Xo-XE-BoM--E--M--o-M-EBEM--M-E--E----oEME?E-----E-o-----Mo--E---M-MM----
-o--B-X-M--E---M??-E-?oM----o?---M?BoX--B--E?---E---X-o--E-MM--o----o-B--o-----XE---Mo-M---X---------B-?--B-Mo-----o--Bo-B-BE---X---o?--M---------E-ME-------B---B-E---?-----?-o--??-oX----B-------Eo-X-
-X-o-B---EoM-oXoB-o--------ME---BE--o----M?-----oE-B-M-XEM-----EM-oMB-?---MXo?------E--oE-----E--ME---XM--?o---o--M-----EM-BXM-E--E-M---MM-----oXoBBM---X-EB-MM-X--?XXX-M------BE?ME-------B----B-----B-
-oE-E-?-XE----M----BMX----M---E-o-?M-X---BX----E---oXM--B??-o---o---?----?-B---oEX---B-oMX-?BEMEBM-Eo-X-B?-M-E-E--oE-----X-E-?-?--XEB-M----B-oooBM-X---?--E-----B-X-MM-XX---Moo-?E-oMoX-X-EM?o--?----?--
-M--B?--E---B-EM---MM--X--M-EXEB--M--M?B-M-E-E-oM---Mo?----X--X--o-X---X-X-M?-M?------M--M----X-----M-B----E--BM---o--B---BEE---B----B?E-----EM-MM-M?--B-X--MXEB---?-----oo-----EM--XMM----E------o-XMM-
-EEMEB--ME-----B-XE?-M-o-B-Bo--oBE---?o-EE?----MXMX--X--MXM?--?M-?----BEE--?M?-E----E--Xo-o-EM--o??-Bo?B----o--MX?--BM------E----M?-M--E---E-?M?--?--XM---MEE-E-M-?-------XEo-o--?BE----Bo-oM--B-X-EoE-v
-E--?------E-?-??-?Eo-------M----E----E---XE---E--X-ME---MEX--o-----MME-------MM?----o--M-B--oE-M-?o--MM--M--B-B------E?E---?ME----?--X--o--MX---------X-----oBX-MX---o--E?----o-?o--ooEMX-EX--E?M-?-MBf
-BBM------oM-Mo--oX---M--EXB--o-E-------B--B-X-?---oM?----??-XE?ME-EM-----?--M---?-----o-MX-o--Eo?-----oM---------X------MM-oMoX---XM-----M---X-BXoB----o-----o---o-o-?----E-E-----------M-EoMo-------?f
----M-?B--M----M-MX--oX-----MM?-------o---E--o--M-----M------EoB---X-E-?--?M--M--BB--B?X----o?-?X-----------MXoM-EMEo-M?--o----XM??----------o-----M-E--X-X?-----M-?Xo--X?-------BBXo-EM--XE---Bo-----Bf
--o----XBo-----MEX-E-BMoX----BM?-----EB----M-??B------M-----BoM---B--E-MEE--?o--B?--?--X--E----M?-------E-B---E---M--Boo--------M-o---ME?--E-----Mo--o-EEXX--E-?---M--E----o-X-M--M-XMMo-B----?B?-----?f
----X-----oo---E--MM---?oX-?----ME--E-----------EoMoEEMMo---E-E----BEB--B--E?-B---BE-EX---MMXoX-------?B---M-XBM--M-ME---E---o-X------ME?--o-M?MEE--oM--X----E--?-M-X----?--M---EB--B-E----------oo---Xf
-MB-B--o-o--X-o---?----?--??-X--?----BE--B-----EX-Eo---?-E---o---M--E---oB----E-----B-----M--?EM-------BoB--M-M--ooEM-MME--MX---M-?--X-----XM?-Mo------o-MB--X---B-----X-BM--?------?-B-M---B---B?--oB?f
m---BE--MX?--M-EB----E?-?o-oo---o-?X-EE?---BM-----Mo-B-BX--------M---B--o---B---o---oM--E-M---MM--EX--B-B-M--------MMB?-??-?-----M---o--BoM-------B-?-MM-X-B-----o-EX-----M-?X--X---?--M-MoE-E-XX?-oE-BX
XXXXXXXXXXXXXXXXXXXXXXXXXXXXXXXXXXXXXXXXXXXXXXXXXXXXXXXXXXXXXXXXXXXXXXXXXXXXXXXXXXXXXXXXXXXXXXXXXXXXXXXXXXXXXXXXXXXXXXXXXXXXXXXXXXXXXXXXXXXXXXXXXXXXXXXXXXXXXXXXXXXXXXXXXXXXXXXXXXXXXXXXXXXXXXXXXXXXXXXX
