--------------------------------------------------------------------------------------------------------------------------------------------------------------------------------------------------------
--?E--?-EB-o-?----?---oB---MEE?BE----X----MB-o--M---E---E?o---X--B-X---B?X-o---X-------M-----o-----BE-XMM-XE------o?--oB--o-XB---X----?B-?-------B---B-X-E---M-----X---E-?o-M-----XB-B----o-----o----M--
-----EB-------Xo---------M--o--?-X-----oX--XX----Eo-|--XB-B-----B-E--E--X--XE?-EM-o---oM-X--E--M?------E----ooXBB?-TX-------M---E---o-o--M-o-----M?-?-B--B--X---M--X-E-BMB---X--E----M----X---XX?M-M-M--
--XBoM---------X----------M?o-EBXX?oB--Xo-X?B--BMMB-|----oME---E-X-E--B?M-E--X---??-----X-M-?--XEM----E--E-M--Bo----X-E--?--oo--------------o--EEo-EX-?oMM-----B-M----B------o-XM--B-T-X---M-X-B--XB----
-o--?o--?oo---MBM-o----?-o--E----E-MB---E-------------------?--X-M--X--E-B----o--?|-----ME-?-Xo-------o-o----?-Bo---------MBX-M----?----XBM-E-----M-E---M?--o--B-E------EE--X---oM---M-o----?---EX--E---
----o-----B-B---X-M--M-E-?E--------M--EMo----?XE-o?-----E---?B-X--o-M-X-E-?--o-X---?-X-X----M-Mo?--?MMMB-M---M-?--EX-Bo?B-?-----E?----?-?-E---EB-----o--E--M---B-----B-o---XE-B?-X-?-----------M----oo--
-M-----M??--M--o-----B----M-M--M--BM---B-EE?-----?o--M-Xo-B--?-|---BBETM-?-------M---B--E?-o----E---M----E----EMo---?o--X----------o-BTBo-E---?oEo-?---BB---Mo---M--oXo--E-X-XX--M--?E--BX?-M----?-?----
--EoX-X-?-----X-B----B--BBB--oo--oo-----M--B--XX--E-oX-B------Mo--E-----------XB-----o---E---o---?---E-o-B-EEX-BE-E-EX--MMB---EM--E---------M---M?---Bo-E--?--M--?oX------M-M-------E----XBX-E-XE-?X-B-v
-----o-----?EE-----?--X-----BX--M-X---------E---E---X--------?X---EEB-----MX-BXoE----BXo-------------oBX-X-X-----?----X--o-?---B-----o-B-oX--XXo------X--MB--X---E-------X?E-BEXM-XX--o-M?--o--X--o-MM-f
---BM?BE----X?----B--BMXM---X-BME---E-oo-EE---EB|-B---Mo--?-B----ME--------MM-BM-B?M-----E-BEo-?----?E-?MM-E----o-----M?------XXM-X-----X?--o---E--EBB-M--XX-----B--BE--?o--o------o------o--oXEM--BM--f
--E---?X-?--X-X-M-o-------M-M--M?--?E--XE---o-?-------oXX?--|----T--------X-----M-----EE----B-M-------M----------B----B--?-B----B-----o---E-------M----X-----MBoM--?---X-------oE-Mo-B---XT-MXEBo-X-X-Ef
---EB----oB----Mo---X--X----?-M---B-B-E--?--?--oB-?------?B--o--o?--XMMo-??-oEXoEX---BT----B---B-----E---MB------E---MX-X-MX-o-?----?E-X-----Eo-----?-M-?-?X----X-E--E?---B--BoTB-EB-M-B-T?E--E?XE-E--Xf
--o---XoX--o-BEX----T?--oE------?-o-?----B-------E-XX------------o-X--MB-------B---M------B-----?-?--MM--o-E?M---?-B-B---E---M-?o--?---------E--B--EXoo---B-----X-X-M-------??Mo--BXB--B---o--M----?---f
-----?M-MM----Xo--E--|-MX----E-X-oB---Eo----o--oXo-B-------?----?-----E--------X-B------X-X----B-MEX-o-Bo---X-------MB--E---M---?M?oE-X---B--X?--B-?-M-X--M--B--?---X-E-B-?BoE--------X-M----MMBEM?--BMf
mX-XE--M--BEoEB-?------Xo--X-X----?-oo|X---M---XB------X--B-M------?------o----o?----------oEMMMoE-oE?oX-B---Eo-X--------??-BBo--------X-MT------|X----oo-X-?--X--X---EME-?---Bo-----B?-M-X---?B-MX----X
XXXXXXXXXXXXXXXXXXXXXXXXXXXXXXXXXXXXXXXXXXXXXXXXXXXXXXXXXXXXXXXXXXXXXXXXXXXXXXXXXXXXXXXXXXXXXXXXXXXXXXXXXXXXXXXXXXXXXXXXXXXXXXXXXXXXXXXXXXXXXXXXXXXXXXXXXXXXXXXXXXXXXXXXXXXXXXXXXXXXXXXXXXXXXXXXXXXXXXXX
