--------------------------------------------B------------------------o------B----o----------------------------------------------------------B-----------------------------------------------------------
-------------------------------o--------------------------B-----------------------------------------------B------B-----------o-----------------------------------B--------------------------------------
--------------------------------------------------------------------------------------------------------------------------------------------------------------------------------------------------------
----------------B-------------------------------------------------------------B-B------o--------------------------------------------B------------------B----------------------------------------------B-
-------B------------------B-----------------------------------------------------------------------------------------------------------------------------------------------------------------------------
--------------------------------------------B--------B------------------------------------------------------------------------------------------------B------B------------------------------------------
------------------------------B---------------------------------B-------------B---------------B----------------------B--B--------------B--------------------BB-------------B----------------------------
----------------------------------------------B---o------------------------B---------------------------------------------------------------------B-----------------B-----------------------------------v
-----------B-----B---------------------------------------------o----------------------------------------------------------------------------------------B----------------------------------------------f
---------------B-----------------B---------------------------------------------------------------------------------------------------------B--------B--------------------------B---------B-------------f
----------------------------B----------------B---------------------------------------------------------------------------------------------------------------------------------------------------------f
-------T----T-------------------------------B---------B------------------------------------T------o------------------------o--------------B--------------------------------------------B--T----T-------f
-------|----|------------------------BB---?--------T----T----------B-T---------T-----------|--------B------------B---B------------------------------------o--T--------------------------o-|----|-------f
-------|----|--------------------------T-----------|----|------------|---------|-----T-----|--------T-------------T----E-------------------------------------|----------------------------|----|-------f
m------|----|-----T--B-----------------|-----------|----|------------|---B-T---|-----|-----|--------|--------T----|----T--E----------------------------------|--------T-------------------|----|-------X
XXXXXXXXXXXXXXXXXXXXXXXXXXXXXXXXXXXXXXXXXXXXXXXXXXXXXXXXXXXXXXXXXXXXXXXXXXXXXXXXXXXXXXXXXXXXXXXXXXXXXXXXXXXXXXXXXXXXXXXXXXXXXXXXXXXXXXXXXXXXXXXXXXXXXXXXXXXXXXXXXXXXXXXXXXXXXXXXXXXXXXXXXXXXXXXXXXXXXXXX
