--------------------------------------------------------------------------------------------------------------------------------------------------------------------------------------------------------
-M-E--MM-M--E-Bo---M--E-------?---o-E--ME-o--?X-o-oXEB--?B--BXEoE--?--XE--E---oX--MB---oX-B?M---X--XB--ME----XB---?-X---E-----B-X----XM-----X--?o-XX---EX--M---MM-E----X------XXMoBM-M--XBMM--B-Bo?---X-
-o-o--------M?-T-M-?E-XM?oE-B-o-oMoB-EB|BoE---E-o?-T--M-TBB--|-B-BMMEX-?X?M-o-M-EE?oE-?oo--MoE-EX-MX--?-TE-X-MXo---?-----?--EBEX|-oo-X-MM-Xo--?T--?--X-?M-X---B--?E--E---B-?E?EB-XEB---EM-Bo----T--XE?--
-E-----B--XXEE-o-?-|o--X-?--|X|M?---E---XT?X-B?o?o?-XM--ET--Eo-?o|-?-?-XXB?M---o-?-B--oT|o-BE--B-o?---|X-----B|---B-M-X?M---o-M-BE-o---|B-o-?-----BEo|---o--XM---M-------Eo-|--M-M-?-----?BE---XB--E--M-
---MB--?-?XBT-oE?ToE-ooMEXoXT-E?--BMo-BMoB--EXM--MoM-|-------TX-M?-o?X--M--B----B-?--M-Eo----??Xo---?-E-E-oM?-E-o-M-?---M-------B|oB?EoX|??MB--MXM--TM-E-o-M-M--B---BEo--B---M--B--?---MEB-----X-----Xo-
-BooBE--Boo----E---?X---|BoX---EXB--|XE-?X?Eo-M-oX-BMB-?---XM-XE-B--?M-XX--M-?-BE----|?|X--ME?--M-?-X-oE|?-o----T-o-----T---EB-M-BMX---oT-M-X-o-B---EEE|o-XM-MEE--E----E--E?o-EBBoM----||B-?----?-X?-X--
-XX-M?--X-|-B-E--M-T?--?T?E--?BEX?-?-XE-E-EBo-E-M--MM---o?--T--E--?-MXXXM-M--XE----EB-oT-?--XM-M-E---M---oE-Bo----T---------??B-XMM-XM?--E-o-o--T?-M?o?-X-o?-o----?----?B---MXoET-M----ME---M?----B--XX-
-?M?E-o?|---EMBX-XB-|B-M-?To-------XX|M-TME?o-B----?-EBo-|--BXM?B---B-T-M-?--T?--?M|EBTE-----TEMo-?E-XoX-E?-BM-E--B-E?M?B-M--?EE-?EM?BEBB---EMXX-TX-X----BBE-?o-o--oMo?EE-----??|BB-------MB--B?-M|--XMv
-B?ME-XBM?o--To---EEM----T-XME?X--E-MXBBXT-?-XM-Eo-T-?oE------B|M---?oE--oX--?-M-XTMMEToBBB-E-BBX-MM-|---EXMBTM-EE-M--BEoo-M-EM--E|?oX-XX-XEE---?--B-----XoEo-X?E-M--?E?-?-E-?oM-|-oX--?E-X-oX---?|--MMf
-|XTB?EXM-X---E-ME--XB-M--B?-MX---B?M?-|Eo--XoEM---T-BM-X----?---?X--XE?XE-B--o--BEX|Bo-EBM-o-|E--ET-o-EETT-o-BME-B??-?E--M---XM--?TM-?--?-EoBM---Xo-XoM-oE--E-XB-X---X-X-?--|?--oMT-E-M?-E?ET-B?B-?X-Bf
-oEBXE---BE--E--B--X|MB-ooEBBE-X--MMM-oEBoX---|-?--EX|-ETXo-EoM-M--XM|B?-E---M--EB-MXo--BX-Bo--|BoBE-TBX?|-?-XBXMMo-M--|--|---BMo-?M|--E--B--?-M--TE-BBM-B-B----|XB-B-|---M-B-B---BX------X----?-EM-M-Mf
---Bo|--MT--M?---XoXX-E?-E-B-M-|----oE-oX-?E-XEM?M-o|-Eo---o---?-M--E-oE--o--X--XXE--------ooE-E-B--E??-EoE?o--|E-M---EB-E----oT--o-oEE--X-XE--X--EX-oMoXBET-?-E-T-?--EB-BEoB-o-?--|----XX--o-?-ooTX-X-f
-----EMo|-X?E--X?EB-MB|BEX-o-o-?-?o-|-EX-XM-o||?o?oo--BTE-?X-?XEME----TM-o-o-EM-|-T-B?-B--XEET-o-XEo--Bo--E-XE??oE|-M-?|oBB-X-XoE-M-E--?-|B|M---E--o-B--|-M|---oBMEM-B--MXoEMXBoXE?---M-----E-T--X---X?f
---X---X-?Mo-----B|--BB--MXXE-Bo??Too---B---M-E?-ME|-M-B|-|X--||--o-?X---BM---E-X---XX?Eo--E-o--X--|o-X-Xo-oo-Xo--X--?M-------XXMM-oo-BoMBX-ME-o-X-B-BEoo?----?-|-XoMo---X?-oMo-BM-M--BMEX---EE?M-ooB-Bf
mE--E---oXM-XEM-X|----TXBo-??XM?BME-BoXo-M?---XMo-T?X-?-B----oX-----XE--oo-o---oTXMB?Mo-M?oT?M-o-o--M-o-?--Mo-oMEoE-oEE--o-BXM--oo?------XM?T-B--o-B-M-M----o--?-X-o?EBM--|--MM---B--oo-|B-BX?-BE-Boo?-X
XXXXXXXXXXXXXXXXXXXXXXXXXXXXXXXXXXXXXXXXXXXXXXXXXXXXXXXXXXXXXXXXXXXXXXXXXXXXXXXXXXXXXXXXXXXXXXXXXXXXXXXXXXXXXXXXXXXXXXXXXXXXXXXXXXXXXXXXXXXXXXXXXXXXXXXXXXXXXXXXXXXXXXXXXXXXXXXXXXXXXXXXXXXXXXXXXXXXXXXX
