-----------------------------------------------------X--------------------------------------------------------------------------------------------------------------------------------------------------
-----------------------BBBBBB----------------------------M--------------------------------------------------------o----------------------------------------------------------o--------------------------
---------------------------------------------------------------M--???????---------------------------------------------------------------------------------------------M---------------------------------
------BBBBBBB-------BBBBBBB------------------------------B--------------M----------------------------------------------------------------------------------------------------BBBBB----------------------
---------------------X------------------------M------------o-----------------------------------------------------------------------------------------------------------------------------B--------------
--------------------XX---????????----------------------------------------X------------------------------------------------------------------------------------------------------------------------------
------------------BXXX-------------X------------------------------------XX------------------------------------------------------------------------------------o--------------------------------------o--
------X----X------XXXX------------XX-----------------------------------XXX--------------------------------------------------------------------------------?--------------------X-----------------------v
-----------------XXXXX-----X-----XXX----------------------------------XXXX-----------------------------------------------------------------------------------------------------XX----------------------f
-------------B--XXXXXX----------XXXX---------------------------------XXXXX---------------------------------------------------------------B--------------------------------X----XXX---------------------f
---------------XXXXXXX---------XXXXX--------------------------------XXXXXX-------------------------------------------------------------X---------------------------------------XXXX-----Bo-------------f
---T----------XXXXXXXX--------XXXXXX-------------------------------XXXXXXX------------------------------------------------------------XX----------------------------------X----XXXXX-------------------f
---|-?-------XXXXXXXXX-------XXXXXXX-------------------XXXXXXX----XXXXXXXX-----------------------------------------------------------XXX--------????????-----------------------XXXXXX------------------f
---|-----X--XXXXXXXXXX------XXXXXXXX-------------------X---------XXXXXXXXX---------------------------------------------------------XXXXX---------------------------------------XXXXXXXo----------------f
m--|-BE--E-XXXXXXXXXXX-----XXXXXXXXX---------------------E---?--XXXXXXXXXX---------------------E--------E--E----------------------XXXXXX----------------E-----------E----------XXXXXXXX----------------X
XXX|XXXXXXXXXXXXXXXXXX----XXXXXXXXXXXXXXXXXXXXXXX---XXXXXXXXXXXXXXXXXXXXXXXXXXXXXXXXXXXXXXXXXXXXXXXXX--------XXXXXXXXXX-------XXXXXXXXXXXXXXXXXXXXXX--XXXXXXXX--XX---XXXXXXXXXXXXXXXXXXXBBBBXXXXXXXXXXXX
