-------------X-o-------------------------------------X----------------------------------------XX------------------------------------------------------------------o-------------------------------------
------------BX?????---------------------XX-M-??????------M--------------X---------------------------------------------------------------------------------------------------------------o---------------
----------BBBBBB---BBBB----------------------------------------?------------------------------------------------------------------------------------------------------M---------------------------------
------BBBBBBB-------BBBBBBB-----------------X---------------------------M-------------------------------------------------------------------------------------------------------------------------------
------------o--Xo------------------------------------------o--------------------------------------------------------------------------------------------------------------------------------------------
-------------------------------------------------------------------------X---M--------------------------------------------------------------------------------------------------------------------------
-------------------XB--------------------------------o------------?-----XX-----------------------o??????------------------------------------------------------------------------------------------------
------X----XBB---?-----X--------------------M--------------------------XXX------------------------------------------------------------------------------M----------------------------------------------v
----------------?---X-XX----------------??????------------------------XXXX-----------------------------------------------------------------------------------------------------------------------------f
-------------B-------XXX---------------?-----------------------------XXXXX------------------------------------------------------------------------------------------------X----------------------------f
----------B---------XXXX--------------------?------B-----------X----XXXXXX-----------------------o----o--------------------------------------------------o---------------------------------------------f
---T------X-B------XXXXX------------oM------------------------XX---XXXXXXX----------------------------T------------------------------------------------------------------------------------------------f
---|--o--XX??T??--XXXXXX-------------------------------XXXXXXXXX--XXXXXXXX----------------------------|-----------????????-----------------------------------------------------------------------------f
---|----XXX--|--TXXXXXXX-----------------oT------T----------XXXX-XXXXXXXXX----------------------------|------------------------------------------------------------------------------------------------f
m--|--EXXXX-E|-E|XXXXXXX--------------M---|--E---|------BEBXXXXXXXXXXXXXXX----------------------------|----------------------E-----------------------------E--------E--------------------------------E-X
XXX|XXXXXXXBB|-X|XXXXXXX----XXXXX-----XXXo|--B--X|--XXX--XXXXXXXXXXXXXXXXXXXXXXXXXXXXXXXXXXXXXMXXXXXXX|XXXXXXXXXXXXXXXXXXXXXXXXXXXXXXXXXXXXXXXXX---XXXXXXXXXXX--XX---???????---XXXXXXX?XXXXXXXXXXXXXXXXX
