-BTM-o-|EoEoTMETXEoTM-oo|TX|-ETM?B-M-oB-MoET|?Mo|MTMME|EBoXEEXT-M?oT|?|?EEoMMo?T?M-MX---|TBTBTT|-E|oM|oB?BBXooTMM?oX?M?BTMEBo|o-?TXTBX|oooEM-BTTTToTTX-EX-Eo-XTT||-MBMXMEXT-TXoTTXoE|B?TB-MoXX-o?--TBMXX
M?---?M-?T--o-M-E--X---|?TX---X-E-o---B--?|-X-TB-B--?E-?----M---??--o-MMM--??-----E-B---MM--B?B-EEB-?|-EX-?-oM-?---o--o--oT--EX--o--E-----o-o-o-XMB--?--|---M----B--oo-oE|-oBX---M----------BX--E------E
ToBo-o--B-E-X-XX?---?------X?---B-oE-EEoB-?MME------E--oX--oo-XE---B--o?---o-M-----M--oo-B------?X-M--M--??--MoMEE-E--M-E--EM----XEE-----B--X--?B?----E--B---B--oM--oE--M?ME--E--E---oM---E---X---------
--X---B-E-??------B----?----X---Eo--?XMM-X---?o-Eo-o---M-----BX---B---E--?-----E--BM-----X-EM--?o-?-----o-B--o-o--MoM--M-E-o-o----------X------XE---M--Bo?--E?----X----X--XE----B--M?-----?E--E-------?-
?X-----X-----B-Xo-?--XM-------X---?-B?-?o-B?-----o-X-o-----BMoE-?XXB--M--oo--oB----M?-E------------X-X-X----X---oB?----B------B-E-EMME-----M----MB-------E-E---M-------------------B----E----------?-?-X
o--B-B?X-ME--XX--MX-?B-o-Bo--------M?---M-?----B---o-X--o---E---M-M-XB-oo?--M-------E-o---E---o--E--oE----M----X------B--o?----oXX--X-----------o---?--M-E---X--o?-M?---X--------M--B-----MoBMo-?---o--T
M---EB-----X-B-MoX--?------?----M--XBE---------XXB-B--?B-o--?E-o---?---XB?XM---BBE-?---B-EXE--XoM-E--XB---X--M---?-----------------o-B?------M--?---o-B----?--E------o-M--E---E-----------o----X--?-MEEX
B--X-E?B?-------E---?--?--E----X---?-X-oX--M---B-o?EM----?-X-BE-----Xo-o---o?X--X-----EE--XX----o-M-M--------?M-E-o--X---o-o----o----E-------B---o-o--o--M----B---M-----o--EE--B---------MX-EE---------v
?-E-M--?-B-B----o---XM--XB-----M---E-?XB?--M--?M-B?---XB-??-------Xo-E?XooB---M-o----M-E?---M----X-Eo-M-----------M----o----M--------B--?-----?-X--EM----X-M-------M--ME-o--XM-?-----M-E-?-----B-------X
TXX?E-?----------B-------?X---?-M-o-E---?-X-?--B?-oo--?----X---X-X--BE--EE---M-Bo---B-----o--X-X-E---------M-B--M??------??X-----X-----o---------E--o----B-BBX---------?-oX----E-----o--o-B---X-?-M--M-T
?---MooXo---XEEE---o----E-o-M-----X?---X-----MBE-o-?-B?M-o-E---B---X--E------M?-MXX-Eo-E----------?----M-E-E?---M----o-B---E-o-X------?------------BM-MB-X----M-B-----o-?--------E--oX?------EBo--B-?---
X-o--X---E-B?---?--MEo--MBMEMX--Mo?----XM---?EE-EX-?---MB----?M---Boo--?----B---oE---?--o?E------E?-----EE-EX-??-M--oE-M---M?-?-?---------M-E-M??o-o---BM------oBMM----B?--X----X-X-M-o--B--E--?-X-?-XM?
EEX------X?E----E--BB-----XE?-X--o----XX-----o-o-?Bo----E?--M----E---MEB-?-?EE-E--X------MoMB-BB---EoB-M--------XB-?XE--?--o-B-M-oB-?B-----?-M---EM-B------B--EBMM-?--?E----?-M---BE---M-M?o-?-?---?--X-
|---------B---X-------MEB--MB----o-E---------X---o------M-----o?B----XT---B--B----M-o--o----?-B-E---X----B?---X---XB---?-----M-----BBX--M-E-?--B-M---X-B--E--B----?B-?-o-?---oE-----?-----o?B-B--XB?X--M
m---?B-oMX--o-X?----?-o------X?B-?---E-o-o---Boo--X-B---o----oo?--?-MBo-?--E-o--B---o------X--BXB----?BB---?E------?--E----X-X-----E-----M---E---------B-B----BB------?o---M-oo---E-E-M-o----?-B?-?B?--B
XXXXXXXXXXXXXXXXXXXXXXXXXXXXXXXXXXXXXXXXXXXXXXXXXXXXXXXXXXXXXXXXXXXXXXXXXXXXXXXXXXXXXXXXXXXXXXXXXXXXXXXXXXXXXXXXXXXXXXXXXXXXXXXXXXXXXXXXXXXXXXXXXXXXXXXXXXXXXXXXXXXXXXXXXXXXXXXXXXXXXXXXXXXXXXXXXXXXXXXX
