--------------------------------------------------------------------------------------------------------------------------MX----------------------------------------------------------------------------
----------------------------------------------------------------------------------------------?-------------------XX--------------------X---------------------------------------------------------------
----------------------------------------------------------------------------B---------------------------------XXXXXXXX--------------BBBB----------------------------------------------------------------
--------------------------------------------------------------------------------------------------------------------------------------------------------------------------------------------------------
---------------------------------------------------------------------------o----------------------------------XB-o????????---------------------B--------------------------------------------------------
--------------------------------------------------------------------------------------------------M----------XX--------------------------------????-----------------------------------------------------
------------------------------------------------------------------------------------------------------------XXX-------------------------------------------------------------o-------------------o-------
-----------------------------------------------------------------------------------------------------------XXXX------------o---------------------------------------------------------------------------v
----------------------------------------------------------------------------------------------------------XXXXX------M------X-M-------o------X-------------------------------------------------------o-f
-----------------------------------------------------------------B---------------------------------------XXXXXX----------------B?-----------XX-----------------------------------------------o---------f
--X-----------------------------------------------------------------------------------------------------XXXXXXX----------------------------XXX-------------?-------------------------------------------f
--XX----------XXXX-------------------------------------------------------------------------------------XXXXXXXX----?----------------------XXXX-------------------------------------T--o-o--------------f
--XXX-------------------------------------------------------------------------------------------------XXXXXXXXX------BB--B----X----------XXXXX-----------------------BBB-----------|--------B----------f
--XXXX---------------------------------------------------------------------------------T-------------XXXXXXXXXX---X---------X-XX----o---XXXXXX-------------------------------------|-------------------f
m-XXXXX------------------------------------------------------------------EBo-----------|------------XXXXXXXXXXXE--E-----E--?XXXXXXXXXXXXXXXXXX-------E----------E----------o-EX--E-|-------------------X
XXXXXXXX----XXXXXXXXXXXXXXXXXXXXXXXXXXXXXXXXXXXXXXXXXXXXXXXXXXXXXXXXXXXXXXXXXXXXXXXXXXX|XXXXXXXXXXXXXXXXXXXXXXXXXXXXXXXX----XXXXXXBXX-XXXXXXXXXXXXXXXXXXXXXXXXXXXXXXXXXXXXXXXXXXXXX|XXXXXXXXXXXX-------X
