--------------------------------------------------------------------------------------------------------------------------------------------------------------------------------------------------------
---Mo-Mo-EM-MM----M--M---oM-?B-B------X-ME-XoE--o-?---?--Xo----BX----EM?EXM---?o?----ME?------o----M----BMX-?----M--?----Bo-M-o--XBo--o-M-MM---X-BE--B---------?--B--?-?oM--o---?-BX-----o-EM----XX--oo-
----oE-?-B--M-----M--?----B--Xo--M--Bo--B-M?o---?X-BE-X----B?o--E----B--|-E--M-?--------M-?----M--M--?-E-XM??-X-------M-o--X-----o-B--X-?o-----M-E----XBB-----MX--E--Moo-M?-XX-M-BBB--X---?oM?X-o?B---o-
--?X-----M----------BXo----EE-----?X-M-E--X--M-X-B?--o----B--|-EE-EMo--M---oXo--o-M-o--o-X-oBMo--X---o---o-------M-M-B-------M--?-------X-----?-E---?X-B-----BX----ooM--M?-X-o-M-E-?MXXM-----MM--E?EBE--
---|-----BE--BB-?-BBE---E-XEBo?E-E-T?MEX------E-oE----E---X--------M?-----o--M----E-E-B-M-------M------B----MB-----E---B---EME?-T--B--E?----X-?--B-------XM---|-X-BX----T--oBMM-o-?-X--oX----BBM?--T--X-
-?--XM?BB-EEX--B?E-|E--E--B-E--BB--M-?--o?BM--?--------X-?-M------X-?-X---X--?M--------------------?BM-M--?-----X-?--E--XB?---o--ME----E-----MMXBo--M------?E----X---M--BX----oX-X--o-o-?--B--X-------|-
-?--Eo----M---X-?o----o----?E----------Eo----X--E-EMo---oB-----BMB-----EMX-------o---o------o?M-BM---E-X-M----X-E--BMo--X---X-?--M---o--o----E------M----oX--------o--BM---M----o---X-?---o-------B-?---
-?-oMB----B-E------o-o-X---o--X--??----E-----?-?oX---X-oE----E-E-E---?M?o?ooE?---X-oo---------M-B?-------o--B-EMM--M-M----?-----X--M?---B?----MBB?---B--M-?X-oEB-M------B-E-M-E--E-Eo---M----B---o---M-v
-B-??|--E-?B-------T?-XE-----X--M-?-E-?-?--oB----B-EE--??B------MoE-M-o---X--X--M----o---o-M------ME--XM-X-X--M----o-----XoX-M--|E-B------XX-oE-o-----?-M---oo--E-oB-B-?--?-M--M----------?-----X----EXf
-EoBXo-----Xo-XBoB-|X-?----M-T----B-X---M-M--M-----E-E-----?EM--XX-----XBo-E---M--Eo----M------M---o------M?---??---X-E------M--E----MM----------M---B--o--XM-B-?----E--M--o-X-|o?X-oM-----?B--M-oEE---f
-?o-Eoo-ooX-X-EM-Bo---XE-B----?o------XX------oX--X----o--------X-----XE---B---MXo?---BE-X-BX-?Xo--Boo-?---X---X---------M-B---------XX--BE--X-B--E--o-?--ME-----o-M?o---E-MX----M------B-E--Xo--E-?M?Xf
---o---B---M---B---E-B---?X--o-----XE---M---MMB----B--X---o-M-?oM-M---|M-EM--M--XXX-o--E?---E-|-?--X?-M?--B-?--B-?E--M--o------o--?oBB-?-oBM-To-X--o--o-M----o-----?------B--M?---X---?BB--o-E--EMME--Xf
-oE----|-----------X----o--E-X--??--M---------??---o--M------oo---M--MB--M--B-BoME-X-X-ET-o--?----o-E----X--X-EXX-BX------B?-B-M----oo---B--?MM-----E---EBXX----oBE--B----B-??--B--MBB-?M---oE-----X?-Bf
------BM--o--------E--o----XX-M-X-M----X----------M-?o-?oE-?-----------------o-o--MX----E-E-E--BX-------?---o----B-XMX--MoEBE?-?E?--o-E-M-----?--XM-o-?-E-B--B?-B--E-oM-BE-M-M----M--B--X-B??-?--M-----f
m-----B---X?-EBB----?---------X?--?-M---X--oE-o?---E---Xo--EM?-E----o-B--E------M--ME-B----?-M----X?o-?-------M-?XM------?o-o---?--Mo----??E-o?E-o--T-?B----X----------X--M---M-?-X---EE?----X---------X
XXXXXXXXXXXXXXXXXXXXXXXXXXXXXXXXXXXXXXXXXXXXXXXXXXXXXXXXXXXXXXXXXXXXXXXXXXXXXXXXXXXXXXXXXXXXXXXXXXXXXXXXXXXXXXXXXXXXXXXXXXXXXXXXXXXXXXXXXXXXXXXXXXXXXXXXXXXXXXXXXXXXXXXXXXXXXXXXXXXXXXXXXXXXXXXXXXXXXXXX
