------------------XX--------------------------------------------------------BB-------------------------------------o-----------------------------??????-------------------------------------------------
---------------------------B-------------------------------?--------------------?????-----?------------------------B------?-------------------------------------------------------o---------------------
--------o---------------------------------------------------------------------------M-----------------------------------------B-----------------------XXXX----------------------------------------------
-------------------------------------------------------------------X----------------B--------------------------------------------------------------------------------B------------------------------o---
-----------------?----------------------------------------------------------------------------------------------------o----------------------------------------------------------------B----------------
-------------------------BBBB-------------------------------------MBBB------o--------------------------------------------------B-----------------------?------------------------------------------------
------------------------------------------------------------------M---------------------------------------------M------------------M-----------------B---------------------------------M----------------
-------------------------------------------------------------------------B-----------------------------------------------------------------------------------------------------BBBBB---o-----------XXXXv
-----------------------------------------------------------------------------X-------------------------------o---------------------X-----------o----????----------XXXXXXXX--------------------------X--f
---BBBBBB---------------------------------------------------------------------------------------------------------------------------------------------------------------------------X--------------XX--f
------------------------------o----------------------------------------------------------------------------------------------o---BM-------------------------------------------------M---X---------XXX--f
--------------------------------------------------------------------------------------------------------T------------------o----X-----?-------------------------------------------------XX-------XXXX--f
---------------------T---------------BB-----------------------------------BBBBBB----------B------------B|---------X------T---------------------------T---------o------------------------XXX-----XXXXX--f
---------------------|----------------------------------------------------------------------------------|------X-----????|---------------------------|---------------------------------TXXXX---XXXXXX--f
mE-------------------|------E---------B----------------E----E----------------E-----------Eo-----------E-|---E-XX--E------|-----???-----M-E-----------|---E---------X-E--------------E-E|XXXXX-XXXXXXX--X
XXXXXXXXXXXXXXXXXXXXX|X-----XXXXXXXXXXXXXXXXXXXXXXXXXXXXXXXXXXXXXXXXXXX-------XXXXX-XXXXXXXXXXXXXXXXXB--|XXBBXXX---XX----|----X----XXXX-------------X|X---?-------XXXXXXXXXXXXXXXXXXXXX|XXXXXXXXXXXXXXXX
