--------------------------------------------------------------------------------------------------------------------------------------------------------------------------------------------------------
--EB---Bo-BM---M--?-B--o?--X--B-------o--B-EMo-o-X-X---B---BE--M--o-E-E---BXB--M-MB--EX----E---BE---E------MX-?--?---?X---E---EM-M---o?-------oE---B--E-B----------o---M---?-----------?Bo--MXX?--B---X-
-----B?o??--------?--B-----MM-E--M-B-?-------?-M---Eo-M---X-E--M------M--oB---o---MEo--M---------------o-X----------o----o--BM-|----B---E------B---oE?----X---E-XX-E--o----B-----o-X--B---o-o-oM------?-
---o-E-?---?-------BX-X--------------------BE-oE------oX------Eo-B-------X----?X-MB--X----E--oXM-MM-BX---?--o-?-?M-E----X-M---B-M-?Mo-X--E-MXM?--------M-EE-----B?oMXEo--------o-X---oEXoME-----o-MB----
-----E-o---oX----M-------o-----MXM-------M?X-M-M--E--?E------M-----E--XB--E--EEB-EMX--oXE--B----B?-EE---MM-M--E--B---MM-E-?---------XM-B--o--MX-XE---B-M-?-E-----Eo--o---o---B---M-M?EM-EX?----B-M------
---E--?E?----M-oX--X----M-Eo---?----oo-X---oX----o-M----M-X---XoX?-----M--------Mo-E---B-------EM----BEM---?-M-M--EM?-E---XB-?oB-M--|-B----X-------o?--oM?----M-?-------B-B--o-EoE---M---?-X?---X--?----
----X-------?M?-?-------M-M-E-BB----To-E-?-T-?E?MM----M-o-B-----?EX----?-oB-------o--M-o-X------M?-----?------B-E------------E-Bo--XX--X---B-MXB----oB?-?B?B---oo---E---M----M---B-M------XE--o-BBE-----
-BXXBMoBo-E--------E-Xo-----?EX-X-M-XMo----?-B--EB---E---XT?----o--EXo-------B-o-M--X--X-M--o---E----E-------??oX-oM---Bo----o--?-E----E-MXX-----EE---M--XEBo--X---oM---X--?EBo-X--X--o-X----?-E--M----v
-----X----o---X?-o-Xo-MMX---?-?---------o--MXX--X----?E----E----o--E-?--X---X--E-M-B---E-X-oX-X-o--------oB----M-EMX--B--EB?-------------B----E--M?-M?B--?---M-M?-BX--?-----E--o------E--o---M------XB-f
-oX----X-o---?-MM---?-----BB------X----E--M--E-B-------?--Mo--B-M-XE-B---B---M-M?---------M------o--------o-X-X----M-E---o---E----oB-----EM-----oB--------BX--Bo----X----?BX-o---o---X---B-----X-----o-f
------o-------ooXE-?E?EM---EEBX----MXE-X-o-X-o--X-E-BX--EBE-------?----XB-o-Xo------XM-o-----Eo-----X--??-----BM-EM-------E?---E-?X--B-o-B----BM---X----?-?X-B----M------B--MB-MM---ooB-M--BB-??-?E----f
----------o---E---M?-BBXM-----E--??oE--o?---?---E------?E-----o--------M-oBE-----Mo-X---B---oX-M-----o?E---B---MBM--Mo--B---?-----M--BEE---o--E----X-M-----o---oEB-B----M--?MEoE--o----EE-?T-?-o-X-??BMf
--o--------B--E--E--X---EM-o-E---|-M---?Xo---?---E--BoB-X-?M--B?-o-E?---o---E--------?--B-?-E-E---?X----oMB-EB---?--M-----o----ME-o--XE-XX-B--EoM-M---?MB-M--M----E------E-E?-----MBE--?E---MXM------X-f
------------E--?--?E?BMo---M----?M-T-M--EB?---X-X--M?MX---E-M--?B---X--X--o---E--X-?-oM-X--MT--M---o-oB-B-ME--B-M-?-----X---o--B--E-BXB---BM?E-?-o---?X----?---o--ME?---EEEEo--o--X--------??B-B----?E-f
m--M--X-X---MX----?-E--M--oE------Eo--B-B---E-?M----EB--o-EoXXXBEB--XE------?----T---MM?---Eo-----X---X-o??--X---B-B----TM-X?---oB|?-----M---X-Eo-X--o-B--M|-B----B-MXo-MM---XMB--BB-M----M-B--Bo--B---X
XXXXXXXXXXXXXXXXXXXXXXXXXXXXXXXXXXXXXXXXXXXXXXXXXXXXXXXXXXXXXXXXXXXXXXXXXXXXXXXXXXXXXXXXXXXXXXXXXXXXXXXXXXXXXXXXXXXXXXXXXXXXXXXXXXXXXXXXXXXXXXXXXXXXXXXXXXXXXXXXXXXXXXXXXXXXXXXXXXXXXXXXXXXXXXXXXXXXXXXX
