--------------------------------------------------------------------------------------B-B-------------------------------------------------------B-------------------------------------------------------
------------------------------------------------------------------o------------------------------------------------------B----------------------------------------------------B-----------B-------------
-----------------------------------------------B-------B----------------------B-------------------------------------------------------------------------------------------------------------------------
-----------------------------B--------------------------------------------------------------------------------------------------B-B---------o-----------------------------------------------------------
------------------------------------------------------------------------------------------------------------------------------------------------------------------B------B------------------------------
-------------------------------o-----------------B----------------B---------------------------B------------------------------B-------------------------o--------------------------------------------o---
--------------o----------B--------------------------------------------------------------------------------------------------------------------------------------B---------------------------------------
------------B---------------B---------B----------------------------B------------------B------------------------------B-------------------------------------------------------B-----o-------------------v
----------------------------------------------------------------------------------------------------B-----------------B------------------------B---------------------B-------o-------------------------f
-----------------------------------------------M-------------------------------------------------------------------------------------------------------------B-----------------------------------------f
------B-----?----------------------------------B-----------------------------------------------?-------------oB---------------o--o----------------------------------------------------B--------o-------f
---------------T------------T-----------------------B----------B--T---T-------T-----------T------------------------------------------------------------------?--B-T------------------------------------f
---------------|------------|--------------------------------T----|---|-------|-------T---|--T---o-B------o--------------T---------------T--------B--------------B|--------------------------T---------f
----o--X---T-B-|---T--------|------T--T--------T-------------|----|---|-------|---T---|---|--|-------T-------------------|--------------B|--?------------T--------|-----BT---T---------T-----|---------f
m----------|---|---|-----T--|------|--|--------|-------------|---B|---|--T--o-|--X|---|--B|--|-------|-----------T-------|---------------|------------T--|--------|------|---|------X--|X----|---------X
XXXXXXXXXXXXXXXXXXXXXXXXXXXXXXXXXXXXXXXXXXXXXXXXXXXXXXXXXXXXXXXXXXXXXXXXXXXXXXXXXXXXXXXXXXXXXXXXXXXXXXXXXXXXXXXXXXXXXXXXXXXXXXXXXXXXXXXXXXXXXXXXXXXXXXXXXXXXXXXXXXXXXXXXXXXXXXXXXXXXXXXXXXXXXXXXXXXXXXXX
