--------------------------------------------------------------------------------------------------------------------------------------------------------------------------------------------------------
-----------------B?E----?-o--E---?-?-E--?----?-MMo-X--oB-----Moo--MB--E----BB-??--oEM---------B-X---X-M-XoE-------M-----B-M-X-B--B-?-oBE---E-M-BE-EX---o-----X--------BE---o-----o---o--M---------X-o---
--B-EB--B---?---X--B-o-M-EB--B?--EX--------o----?------M------XM-X------X----------EEB-E------?--------?-|M-----Eo-M----o-??--------X---Eo-M--M?BBE---XM--X------X--B--Bo-Eo-BB-E-----B-M----X-o--EE----
--X-o--M-oBM-X-ooB-M-oM---BE-----?-----E?-XXEXE?-o-E------EB----B?M------------ooE-B-----X-MEoM---X-B---o-?-?o--XEXoX?----E--M-M-M-----E---E-----T-E----E--?-o-----M----E?---------o----X---M-o?X-X---M-
--M-B-BBM--------??---B----M---B-Mo---M-B--B-------M-----o--E------E---o--?-----MX-MMX-----?-B--o-?-M-XXMo--BM--oo-----?EMB?-----?-?o-o--EX-MX-----oBB-M?---------M-EMB-M-E-o-?---BX-M-Bo-M---MM-----X--
----?-----M--E------?--Mo--XX-----?E-o-B-M---M----?--oB---o-----?---XE-X--XEEE-M---MM----B-M-Mo--?------MM?M-M-?---M?-B-o----BBo--B-M--o-EX-----?--?B?-----?X--EB?-XX--E-oE-Eo--X-o-BMEBBM-----o---E-o--
-??-E-----X-E--?-XM----E---XE-------X--oB-----M-oM------X------o----oo-?----BE--ME-B-----XEo-B--B-M-XB----o-----?-EX--Eo----X?------E---E----M-?-?M----?EXE?------M-?-B----?-MMEX---Eo--E-XBMB?M-M--?---
-B-----B--B?-EBE-----M-E-?-----XE---X---X--?-------B-----------ooX---M-----X?M------E-E----?o--EB-??B----B--E----E-M--?---------E--B---?-----MEX-oo----X-o-Eo----E--X-E---M?---o---X--XM?Eo---o-------Mv
--E?E---o-oo-oB?------XMB?-M---------------------------------o--------B---B--BoE--?-X-B-B?---?--?EEMM--M----BM---E-M-X----ME-----E----o-?-BX-----M|o---E----o-----XM-----E--M--EX-----MM?---E----EM--E-f
-o-E--??-EB--B-E---E----?-X?--MB-----EB---X----B-?E-B-EE------X-X---B--X--X--M--o--E--E-B---E-MM--o-MB----X----?MX---?-E-E-o--?-M----MXX--o---X------E-B-----E-o-X--?-------M-M-o---E?---BM-M-X-------of
-E--X--BoX?---Xo-??--o--?EE-XBo-B---EM-o-??---X-----X---Eoo--E----------E-M?-?M-X--Bo---------M---E-------X-MM----ooX-----o---MMM----o-B--oXo--BB?--M-----o--E-E--o---?-?X-----o-?M--o---E-B-X-----?-MMf
-oB?B--?----BME?---------E-oX-X-----o----XXo?-|---B--Xo-EB--B---o----o-M?X?------EB-?X-oB-o-o-E-----Eo-o-?-------MXMo-XB------?X---X---E-----o---?-B|E---B-o-X------?X-E---EE-E-o-----E--o------?E-B---f
-M-oo----Xo-M---M--oBEB--MX?B-------X--BBMM-ME----X--EB-BM---M?----EooM-?M---o-E-BM--B--?--B-----M?----?---E---E----X-M--E-----B-E-o--B-MB-X-XE---o-----Eo-o-----Bo----EX--EE-B-X---B-X?---E----BEE-B-of
---?X--M-?---------MX---o--?---oBB--B----o---?X-B----B---TB-BT-----?-----M---E?-B-o--?-Mo--B---MoE---o---E----B--oM--E--X----o---o-----Xo------?M---X?----MME--Bo-?------?X-M-EBT--M-X--X---?--M----B--f
moB?-E--E-------E-X--M-X-E-B---E--?B-MB--M-----X----o--?oXM-|--XE-B-oX---E-E-----M-B--E-MB-EM--X-BM-B---M?---XEBB---E|---o-X--E---o?X------------B-o-B---B-T--X---B----?-EE--ooE-BBM--M-XM------oX--?-XX
XXXXXXXXXXXXXXXXXXXXXXXXXXXXXXXXXXXXXXXXXXXXXXXXXXXXXXXXXXXXXXXXXXXXXXXXXXXXXXXXXXXXXXXXXXXXXXXXXXXXXXXXXXXXXXXXXXXXXXXXXXXXXXXXXXXXXXXXXXXXXXXXXXXXXXXXXXXXXXXXXXXXXXXXXXXXXXXXXXXXXXXXXXXXXXXXXXXXXXXX
