--------------------------------------------------------------------------------------------------------------------------------------------------------------------------------------------------------
-?E----?o--o--M?-------oB----EE-MMX-o---E--EX---?------E-M-X------E---EXMB--Mo----EM------EE-----?------E-------X--X----------M----MX------M?M-MM-------------M---X--X----B---B--E-EBo--ME?-----BXX-----
---E--?---E?--M-?MoB---B---E--o--MX----BM----Mo-BB-EEMXM----?MXB-o--o--?----?---o-X------------?---o------EEE---oE--Xo-MB--?B-M--E-?--?X---MB--B------X----BM----X--?-BX--EE--B----XX-B---o-M-M?X---o-E-
-Xo?----XXo--------B--XX-?---B-X------B-E--B-?--o-B--B-E---ME--EEB---B------o-EE--M--X--?XoX--EB----E-----oEo-B-E-----X----BM----B--?B-----?-E----o-X--ME-B----B--B---X--------o-B-?---?---XBB----Eo-XE-
-----BM---oB-----------XME?ME-M----E-?o-----EB--BB-X----B-EXM--E?XX-X---?----XMo---?--?--M--oo--?---o--o--------o---EoMM--B---E--EM--o-M--X--X---M--oBoE??-B--X---M-------MB---XMM--BME-XX----M--oo-Mo--
--o-M---ooXB-Moo-oo?-B-?--BE-M-o-B-----MoX--EX---?---?-----B-----X-M-----MoME--T--?--M-MX---oE-?----X-?--BM------?M-oo-E-o------?M-?-o--Xoo--B--Eo--?-B?----o-M-B----E----XM-----Eo-BB---M--E?--E-X--B--
----------?--E-----o--o?BE-MX---?o?----MB?--BXMX-M-o-X--oM---?BEX------?BM----?----oX-o---EBM---B---o-o-X-oM-X??---X-XBM?Mo--M-?BB--o---??-Bo-M-M?MM---oB--o--M--B--XT--Eo-----?E----XBM--MXB--?----?---
--XE---EoEE----M---o--?-o?-?--MB-o--oM--?o---XoBX--XM--------E---oB?Bo---MMX--o?X----------o-----?--B-?-B----M?oBM------oooBo---XM-X----|-X-M-M---o--B--?---o-E?X---MM-?-M-o-------o---M------o-E-M-?--v
--o--?----ooEo---XM--------E?--M---E---??--EE----XE---M----EMo?o------E--?--E-MX-?E--B-MBB?o--Mo------B--E---M-M-------E----X-----X--B-----X-o----B-?Eo------X-E--X---E---------M----XBMB-XME-o---?-B-Ef
----------Bo-EE-----------XXM-----??-o-o-o--X-BEE---X--E---oE?E--E-E---E-E-B------B-?-ET-----E---------o-B---E--?--M--?EoM-?B-----B--?Eo-o-M-B-oB------oX-----BMX---?---EMB-ooo-------E-B--BB---BB?----f
---M--M--MB---TXX-o----MB----B--?oB?--E-------?--o---B------M-o-B-?---X----------o-E------E---o-E?M-M---M-oB----?E-----BE-M-?-M---?---E--X-M---o---M??--|-?----EBME-o-?----o--M---o--o-BE--o?-M---o-X?Ef
-B-?---o--o---TB?X-?-Mo-----o-E--X-oMBE---M-?-E-----BB----?o------o---X----MMMo---M--?----B-M--X-?----oM?----BM-?B--??-------o---M--E--B---E--??-?-EEXBM----M----B-X---oB--o--o----B--?-B--B-----oo-B--f
---EB-E---?--M---oM------E------EoE---XX--o--X-oX-----B?E---o--M--BE-M--?B--X--E---------M---ME-------oE---------B--B-----X----M--oX--?--B--oB-X?XE--E|oE-EEMEX--B-E----X---?---M-M-?----Bo--?-X-----B-f
-E-MX-----XE--o--o--EE----X--oo--?-o--?-BM----X-BE----oX---M---M-M-----B----XM----E-MX--M---B-EMM---ME--B-ME-----?--E---?--------M-MB-Mo----?---oX?--M-?--B--M--oX?--B--o-------B?-o-?X-----Eo---X--B--f
mEM?XXBM---?-X-X-X--E--oB-E-M--?-B??--BX---B-MB-B?---E-?--M-Eo---M-----o--------EM-----?-o-E-B?M----oX-B-XE--?--B-o--X--oX----o--|-oXXoX-X---?-?-MM-M-X--o----X-?--E--E--EM------M-?-?E--?--?-----X-?XXX
XXXXXXXXXXXXXXXXXXXXXXXXXXXXXXXXXXXXXXXXXXXXXXXXXXXXXXXXXXXXXXXXXXXXXXXXXXXXXXXXXXXXXXXXXXXXXXXXXXXXXXXXXXXXXXXXXXXXXXXXXXXXXXXXXXXXXXXXXXXXXXXXXXXXXXXXXXXXXXXXXXXXXXXXXXXXXXXXXXXXXXXXXXXXXXXXXXXXXXXX
