--------------------------------------------------------------------------------------------------------------------------------------------------------------------------------------------------------
--------------------------------------------------------------------------------------------------------------------------------------------------------------------------------------------------------
-----------------------------------------------------------------------------------------------------------BBBBB----------------------------------------------------------------------------------------
--------------------------------------------------------------------------------------------------------------------------------------------------------------------------------------------------------
----------------------X---------------------------------------------------------------------------------------------------------------------------------------------------------------------------------
---------------------XX---------------------------------------------------------------------------------------------------------------------------------------------------------------------------------
--------------------XXX---------------------------------------------------------------------------------------------------------------------------------------------------------------------------------
-------------------XXXX--------------------------------------------------------------------------------------------------------------------------------------------------------------------------------v
---------B--------XXXXX--------------------------------------------------------------------------------------------------------------------------------------------------------------------------------f
-----------------XXXXXX--------------------------------------------------------------------------------------------------------------------------------------------------------------------------------f
----------------XXXXXXX--------------------------------------------------------------------------------------------------------------------------------------------------------------------------------f
---------------XXXXXXXX--------------------------------------------------------------------------------------------------------------------------------------------------------------------------------f
--------------XXXXXXXXX--------------------------------------------------------------------------------------------------------------------------------------------------------------------------------f
-------------XXXXXXXXXX----------------------------------------------------------------------------------------------------T----------------------?----------------------------------------------------f
m--E--------XXXXXXXXXXX----------------------------------------------------------------------------------------------------|---------------------------------------------------------------------------X
XXXXXXXXXXXXXXXXXXXXXXXXXXXXXXXXXXXXXXXXXXXXXXXXXXXXXXXXXXXXXXXXXXXXXXXXXXXXXXXXXXXXXXXXXXXXXXXXXXXXXXXXXXXXXXXXXXXXXXXXXXX|XXXXXXXXXXXX--------XXXXXXXXXXXXXXXXXXXXXXXXXXXXXXXXXXXXXXXoXXXXXXXXXXXXXXXX
