-------------X-o-----?-------------------------------------------XXXX-----------------------------M---------------------------o-----------------------------------------------------M-------------------
------------BX?o???----BBBBBB------------------------------------------------------------------o------------------o-------------------------------------------------------------------------------------
----X-----B--X---------------------M--------------------------------------------------------------------------------------------------------------------------------------------------------------------
--------???---------BBBBBBB------------------------------------------------------------------------o-------------------------------------------------------------------------BBBBB----------------------
------------o---o-----------------------------M------------------------------------------------------------------------------------------------------------------------------------------B--------------
------------------------------------X------------------------------------------------------------------------------------------------------------------M----------o-------------------------------------
-------------------X---------------XX--------------------------------------------------------------------------------------o-----o------------------X---------o-----------------------------------------
-----------XBB---?X---------------XXX--------------------------------------------------------------------------------------------------------------XX---M----------------------------------------------v
----------------?XX--------B-----XXXX-------------------------------------------M--------X--------------------------------------------------------XXX--------------------------------------------------f
-------------B--XXX--B----------XXXXX-----------------------------------M---------------XX-------------------------------------------------------XXXX-------------------M------------------------------f
---------oB----XXXX------------XXXXXX--------------------------------------------------XXX------------o-------------------M-----------------????XXXXX----o-----------------------XB-----Bo-------------f
--------------TXXXX-----------XXXXXXX--------------------------BBBB-------------------XXXX--------------------------------------------X-----?--XXXXXX----BBBB-------------X----------------------------f
-----?o------X|XXXX----------XXXXXXXX----------T-------------------------------------XXXXX--?---------------------????????--------------------XXXXXXX???-----------------------------------------------f
------------XX|XTXX-------o-XXXXXXXXX----------|--X---------------------------------XXXXXXM--------------------------------------------------XTXXXXXX--------------------------------------------------f
m----?E--?XXXX|X|XX--------XXXXXXXXXX----------|--------------------E---E----o-----XXXXXXXX-------------E----------------E------------------XX|XXXXXX---E-----------E-----------------E----------E--o--X
XoXXXXXXXXXXXX|X|XXX-XXXXXXXXXXXXXXXX-XXXXXXXBX|XXXXXXX--XXXXXXXXXXX----XXXXXXXX--XXXXXXXXXXXXM--XXX--------XXXXXXXXXXXXXXXXXXXXXXXXXXXXXB-XXX|XXXXXXXXXXXXXXXXXXXXXXXXXXXXXXXXX-----XXXBBBBXXXXXXXXXXXX
