--------------------------------------------------------------------------------------------------------------------------------------------------------------------------------------------------------
-----------M---MXo---E-Mo-MX-----M---E-----B--E-M---?X--EB-E--o--M-----M----E----X----B---B-B--oE--?--E-?BM---?B-X---o--o---E--E--EE----M--o--E-X--X-M---o--B-E-E-B-Mo-X?----------X?o--M---M-----?-ME--
---?-E--?-Mo-BME--------EE---B-------MB---------X--X-------o-o?B------BM--M--?o--oXBE-------oM---------E-XB-X-----o--o--oo--?--o-----o------BE-B----M--M-B-----o-MB---X-E?-o----X--EB---o---M--E--E-----
-?MX--?--B-------BXM-M---oE--o-------X-B-----X-B-?BME-X------?--M?--ooB--X----oooMo----??---------B--M-X-?--o--ooBMoBME--E--B-M?--X--M----Mo-?---?---X--E-----o---MM-oXE----?----?-o?-Mo--XM--BM--o--Mo-
----------o-B-----XX-T----o-E---------B--?---E----?-BB-X-X--?--ooM----E---EB--B-oEoX-M----M-M-E----EM-M--o?--EM-------BX--E?B--?M-ME-M-EB?-------E----XX?--B-B-BM--X--E-Bo-?X-?E--o-o---X--MB---------M-
-M---------X-E--M---?-XM--o-B-?--B-----M--------XE---o----E-EMX--?--?-----?-------X--M---?B--MX--------o-M-E--o---M--B-E?M?-----o-o---E--oX-----BoE-----?----B------X-EEB--Boo----oEE??-o-o-E----?---Mo-
-X-o-Bo-o---?---MoX---??XEMMMMM----M---M------M?-oEMB-------o?B-M--X--B-Eo--?E--E--E--M-------B------X-?-BE--X?-XB--BX---------o?---o---EE----o--?ME--B----X?XE-?-------M--------M----o-E-----MoMoB-?---
-B---------BE---ME---M------o--E----M---BX--Bo--??-------?EBB--o-----XM----X-M---XMM-----o-----?--M----?X-?--E-------M-----?E---------B-----o-o-?--M-B-?-B?-X--X------------X-E-----o-oM?-----M--------v
---EM--------XX--X---E----E--o---------------To-----o----B-X--------Bo----o-X?-B-M-?--B-B?M?---Mo-BM?----M------Xo--Eo?o--o?-----M----------X-------X-----?X---oB------E-XM--?---------M----E------X---f
--Mo?-B---oE-M?--o----X--o-M-|-B------B-o-----MM--B-XX-oo?-MBM?-------M-B-|?M-M-?X---BEX-M-----ooM-MM--o--E----M--B---X----X---X-?----oX--B----oo-X-M-oM-----EMB-B-BBB-MBBXB--X-Mo-------B-o-------M?--f
----B-o-BE-o----X---Eo---X-BX--??-B-oE-X---o-EM-o-------M--B---?----X----XM--o--?-------?-----o---B-M--------EB----?-------?-----X-E--------E-M-----B?---XE-M?---B-E---B--X---M-TXo----XE--ME-X---X--B-f
--BM-?-o--E---M?---BB-B?--o--?EXX-o-B-Eo--Xo--X-EE-E-o--o---?-----?EEM-MM-?-EMMMXM--XXE?-E---BM---M-ooo--??-M-E?-------BB-M?----XoXE?---MM-X-X--BE-MM-M---T-E-B-M-oo---o---------BoMB-------o-X--M-M-M-f
------B-X----M--?X-----|---o?--B-?-M-X--X--E---B-oBEBoB---?-o-E-?--?---?-X--?B-------o-o?-?MM-----M-T-EB-----MXX---oM---------?-MB---M--M-?-----M-E-X-X-?---------E----X-B--o---E----M--BX--ME----MooX-f
---E---B-o-E--B--|--E--E--E|X-o-?---M------ME-MM-X---------?-----BX----EE--XMEo---Mo--E--E-B--EXMEM?-E---X--X---E-E------?------o---------X----MB-XoMX--------Eoo-?-------EE--XB-E-----X----B--B--?X-E-f
m--MXM--------B?-------o-----M----?-MM--------M-o-o--X-----?-X--E---X-BB?--?XX---o--XME--X----??-X?--?M-M?o---X---E-----oX-X?-??---?o--X--M-E----B--o----B--E-oM--EB?-o------B--o-----X-??B-?BE?o-BM--EX
XXXXXXXXXXXXXXXXXXXXXXXXXXXXXXXXXXXXXXXXXXXXXXXXXXXXXXXXXXXXXXXXXXXXXXXXXXXXXXXXXXXXXXXXXXXXXXXXXXXXXXXXXXXXXXXXXXXXXXXXXXXXXXXXXXXXXXXXXXXXXXXXXXXXXXXXXXXXXXXXXXXXXXXXXXXXXXXXXXXXXXXXXXXXXXXXXXXXXXXX
