--B----------------------------------B----------------------------------------------B-----------------------------------------------------o------------------------------------------------o------------
-------------------------------------------B--------------------B--------B-----o-------B----------------------------------------------------B------------B----------------------------------------------
---------------------------------------------------------------------------------o---------------------------------------------o---------------B-------------BB-----------------------------------------
--------------------------------------------o-----------------------------------------------------------------------------------------------------------------------------------------------------------
-----------B------------------------------o---------------------------------B---------------------------------------------------------------------------------------------------------------------------
--------B---------------------------------------------------------------------------B--------B----------------------------------------------------------------------------------------------------------
----------------B------B--------B-------------------------------------------------------B-------B--------------------------------------------------------------------------------B-----B----------------
---------------------------------------------o-o------------------------B-------------------------------------------B-------------------------------------------------B--------------------------------v
-----B-----------------------------------------------------------------------B-----------B----------B------------------------------------B---------------------B------------B--------------------------f
-------B-------------o--------------------------------------------------------------------------------------------o----------------------------------------------------------------B-------------------f
----M------o------------------------------------------B----------------B----------------B-----------B------------------------------------------------------------B-------------------------------------f
---------------T---------T--------------------------------------T--------B--T-------T---T---------------------------T---o--------T--------T--T-------T--?------------------------------------------?---f
---o-----T-----|---B---o-|----o--------T---T--------T---T-------|----T------|-------|---|--------------T------------|--T---------|--------|--|---T---|--B-?-----------T---T-------------------B-----B--f
---------|-----|-----T---|-------------|---|--------|---|-------|----|----B-|-------|---|--------------|------------|--|----T----|X-------|--|o--|---|----------------|---|----------------------------f
m--------|-----|-----|---|-------------|---|--------|---|-------|----|------|-------|---|--------------|------------|--|----|----|-----T--|--|---|---|-------------XX-|---|----------------T--T--------X
XXXXXXXXXXXXXXXXXXXXXXXXXXXXXXXXXXXXXXXXXXXXXXXXXXXXXXXXXXXXXXXXXXXXXXXXXXXXXXXXXXXXXXXXXXXXXXXXXXXXXXXXXXXXXXXXXXXXXXXXXXXXXXXXXXXXXXXXXXXXXXXXXXXXXXXXXXXXXXXXXXXXXXXXXXXXXXXXXXXXXXXXXXXXXXXXXXXXXXXX
