--------------------------------------------------------------------------------------------------------------------------------------------------------------------------------------------------------
--oX----M---?o---M-B---B-ME?----XM?----BE-B--------M---M---o?---------o-M-----o?--X-Xoo?----M-o--EB--Mo-oXE-----Mo----X?---E-BX----EEB-M-B--M-?M-X----E-?-BMB?-?MX------X-oXX-M-E-o--?B-?XE-XX?-X--Xo-?-
---EB-------X---o--M-o-E-|--------X-EE--E-E-B--M?--B?--B---o??--XBo-EB-Xo-EM-M|M--------M-MM------X------E---EE--XM-M-X---M------o--o---o-X---BXM-oM--MX-X----X----o--E---?BX----BBoBo---ME-M-XBE-?M--o-
-----o-E-X-M-MX-----M--?-?o-?----o?---E---T----o----E--------M--?-o-BB-?X--?X--E-----E-M?E------?-M---E-------oo--BE-?BM---XoX---?-B------X--M?-M------MB?B-?--X---ME-?-oM--B?-?---MX-oXE----M--B-??-o--
-------oX-----ooB-o-?--?------E----Xo------X-----BM-----?B----MM-o----------------?MB----M---M-XB-BM---M?-E-EBB----?-X-o-E--X-----?Mo---?X-?MB--XM------M-B-----B--ooB--X----X-o------o---B--oX--M-o?-M-
--B?-E?--o--M-M-oB---BB-M-----o----B----oX-B---E?-M---oo----M--?---XXo--oE-B--------B---M-MX--X-?-MB-BMEE-?-E-----B-EM-BB-?XB-BXBM-X-B--XX----------X---?----o?--X--BB-E-X---o--M---oB-B---Xo---o?---BE-
-----M---X-B--oE--MM--?-B?E--Xo-----B-----M?oo-EB-?X--o-XBB------X-o-----B--?-BB?oX-ME--EEo---E--BXo--E-B---E-----EB--X-X--EX-----?EM----X??-XB--E--EM--o-B--------E--EB-X-?-??-?-?-M--E-?-o--?-o-B?E---
--Mo-oM?BB---------------------B------B-?-----XX---o-EE---ME-M---X-BB-X---------o-B---o--E------BE-o-----MB----M-?E---o--X--E---EBXB?---BB-M--E--M-?ME--?---B---B---?-E--B-----M------?--T-M?-------o--v
--M------------M---B?-------?--?--B--ooE---B--o--X----X--E-X?-o-?--M-M?---BXX--------?-?--o---E----X----B---BE-?BEEBoX---M-oXoXEE--------?-Eo---B---E-------?---o-oX---B---oo------?--MXB----M---MB---of
-B--EB--XE-?BE-o----?-M--E---M--E-------B-X--------BE-oE---B---?-----------?-E-oE--ooX?-?o----oE-B---EE-BBooMXX?-M?--BE-E-------B------E-B---E----EMEB-MEEo-XB--EM|-X-?--?---Eo---M-oM--?BXM-o?XM--X---f
-Xo--?X--oB???----?BM?--EM-B--EM-------------M--?---oXME---o-?MoX-B---B-E-o-?---X---E---------?EoE-?-?-------E-----X-------X-E?-X---E----MB-X--E--o-B-B-Xoo-----E?----EB--E?---E---EX??--X----------E--f
-oB---?X-E-B|M-----X--BX---?X?----X----M---X--MX--X-----M--BE-----M--B---oX-M--MB-oE-?-M-EoE---------B-E-X---BB?--o-X-----o?BX--BMo---?M------X--EXB-B--X--E---o---o?B-M--ME--?---B---BMoB-M-B--?M----of
----?---oo-M-----B--Eo----B-----?M--M-?M----?--o--B--o--X-M-X?o-o?---?---?------X--E-X-E--X-X-?BX--M---XB-M-Eo---E--B-o--?|M-o---X-----oo?o?o-B----?-M--EM--M-?oo----EM---Mo---B-M-XEo-M--X-----E-B-X--f
--oE------Bo-ooM-oB----B?--E-?---M---E?--oBX---MM?E----BM-BB-EXX-o---BE---?EX?o--o-M---XX-B--EXX-M--Bo-M--?--X-Eo--E---?------oX-?-----X-----EE----ME-----------------E--oE|---?--B-|-??--------------Mf
m--o--oX---?B-?X---E-M------?X--B--o?B-Eo---B-o-E-B?-------X-XT------------?B-X-X-MX---------M-----E----?-E---E--?EX-o----M-X-MB---X--EX-----------o-M----o-o---EXM----B------BB--M-X----M?M--o-o--?B--X
XXXXXXXXXXXXXXXXXXXXXXXXXXXXXXXXXXXXXXXXXXXXXXXXXXXXXXXXXXXXXXXXXXXXXXXXXXXXXXXXXXXXXXXXXXXXXXXXXXXXXXXXXXXXXXXXXXXXXXXXXXXXXXXXXXXXXXXXXXXXXXXXXXXXXXXXXXXXXXXXXXXXXXXXXXXXXXXXXXXXXXXXXXXXXXXXXXXXXXXX
