XTXE?XBEMBTTMT?M?BMB-|-|BT-XBT|MXB-||ToTBM|B?MBEo-??TE?ETXMXMBXoM|?|MEB||XBoBB|||X|oXMET-|o-EXEET--?MBB|XTM|||MTMT||o|TX-E?BTMT-|??-TMT-XEo|E-BXBE|o?|-ooTo-MB?MMEM|o?o?||oM?oMB-EET-XoTXoBoTT-|MT|---EE
?E-M----M---M------EooB--M-----?ooM-BXE----?-o----B?MEM------X-o--?---BoE---B----oX---MM---M----E--Bo-BM---M---o--o-E------E--????B-?X--BBB-MMB--M----?--M?o-X---X------?-o--M-XXMEM--Bo--E--------?-??E
B---------o-BX-----M---XM-----Mo--X-------?M---?-MMo---M-M---E-o?BX-M-B-o--M?---EEXoE-?-?-X---E---XB?-----B--oEXBE--o------?X-?----o---BoB-M-E-XM-Eo-MM--X--XB-X---o---X--?----o---------MBBM---B-?-o--|
T-M-----oooE-EX-?B-|--??-?--------oM-E-B-MX-o-E-------------?---?---Xo--?BEXX--E---o-X-M?-----M-----?-E-B-----?--?M-T?oE?-B-M--X----B--M--B?-M-EM--BX---B-X-----oMB--B--?-M--o-E--MX--?--X-oE-EBX?-?--EM
EM---Bo-----B---B----Eo-ME-B---------------------?BoE-?----EM--X-B---------B--?----B-o-B-o-EB---o----X-E-ME-o-B?---oME-o-?--X--XM----o-M------E--X?-B------E--XoB--o?E-o--B-?-B-------o-X?--XE-ooE-o-B-E
--E-?-?----?M?-----M----X---M--o-o----B-----M-----M------oBM--------E------X--X-?X--B---oo-Xo-E--o-XM?-----o?-----Bo-E--Mo--EB-E-X?---------B-o----B-----BB?E?---MXM---o--?Xo---MB-Xo-MB---E-BoBB--o---X
?o--BMBB------M-B--X--?o-B--?-----X-X---MEMo--oE--?E??---E----XX-M--Eo----?---EE-MEEM----XE|-Bo----?--E-B-oX--B?-E??-?EB-M--o-----X-----o-----M---E-o-B-ME-M-o-----B-------E--??XMXMB---E-?X-M------?--X
|---MX--?-----M-X---o-----Mo-X----X-?-E-----M-oXM-E-X------------MMB-------M----BXE-E-B-o--o-EBoo--oo---MM-------BX---Bo-B--E-B?-----X--M??X------MM-XE-o-o--B--E-----MBB---B--M--XM-ME-B?B--E-?----XoEv
M-X----o?---B---?E-?o--XMM-M?o------B?--E-??---oB--o-?B--E?---?-B----oM-?o--X-----EE------XM-MoX--oXX-X-----B-E----------M------E-?--BX-o?--Eo-M-?----M-------X--BX---o---M-----B-----o-E----X-M--X-B-MB
EX-B----X--o----o-------X--M-E-----?E?-----MMo?--M-BB------------------?--X-o-E--MM-o---------|----B-EX?-----o--------E?B-o---M--ME-----E-----M-o-EX-M---Eo---o-BE|---?----EM-B-X-Xo---M---E-----M-BX--E
E?-o----M-E--?-XX-o------M--E-MEX-M---?--E-?EM----B--X------M?-B-?M--Xoo?-----BB-----M---XXo--o-oX?-M-XBB-E-BE-E-E-o-E--XMEo-MB------Eo-E---X------XB----M-B---oX----M-?---M--oE-XE--?B--?--B----B-E---E
M?----BM?-----oE-o-EX---M-o-?---------M-X-B---B--EB----o-?-B-M-----E---X----X--?o--?--E---------M--X---XM-EB-MB-X--MoB---?-------M-M--M--E---------?-BE-?------oEME?X-oM----Xo--?-E-E--------B-BXB-oE-M?
TB-Bo-B--EMBB----?-----------?-oX--B-B-M--M-?o-----MoB-B---M-B---??---o-----E--?---------?-X-?oB---B--?--------o-E--o--o-E---BM--X??---E-X--o--M-X---Mo---o---E-E---E-?-X-M-M-o-o------M--XEME---oMo--MB
|----X--B?--MM?oMooX---?MM-o---M---?E-B-----X-X--?-o----------EX---MoX?--E?M-M---?X---o-MEB-B?-?---------o?----o-E--------BE-o----M?--EMo----M--M-o--?Mo-X----M---ME?---M-M----o-B-X-----X--o--E-?-X-X-E
m-----EBM---B--M-X---EBo--M-?--E----B--M--oB-M--?-B----o-----X-EB?o--B------oEXoXXX-X--E?----MB---BXX--M?-?------BB-Bo-----oBo-o---o-?E----B------E?Bo?E-XX-Bo-----oB-o--MXX--EE--XE-E?----o---?-MM?-X-B
XXXXXXXXXXXXXXXXXXXXXXXXXXXXXXXXXXXXXXXXXXXXXXXXXXXXXXXXXXXXXXXXXXXXXXXXXXXXXXXXXXXXXXXXXXXXXXXXXXXXXXXXXXXXXXXXXXXXXXXXXXXXXXXXXXXXXXXXXXXXXXXXXXXXXXXXXXXXXXXXXXXXXXXXXXXXXXXXXXXXXXXXXXXXXXXXXXXXXXXX
