--------------------------------------------------------------------------------------------------------------------------------------------------------------------------------------------------------
--M?-E-o---?M-EoM--o-BX-X--ME---X--?--X-MM---E---Xo--o-o-EoB---?-?-----M--?o---o-o-EE---XM-BM-Bo--EM-----M-?----ooM----o---BE?-----E-??---E--B-XEM--BE--------o-B-EX------EB-B---E-----------------E-BM-
-------XX------Mo----M---X-o-M----B--oM------ooo---X--?M??--X-B-o--X---Eo-B----?---X---oXXE-E-ooM---M--E-?ME-XM----E--??---X--o--o?B----B--EX-XBB--M-?XBo-?-M---?-B----oE-BB-EEE---E-XB---B--?--B-?B?---
--XB--BE---------X---XM-o?o?--X-oo-oM-TE--M?-?|EXBo---X--X--o------E-M----??----M------?-E--o----------?----M--o-E-X--M-----?----X-E--?--BE---?E-E------E---BBE----o---oE--o---|E-B-B???-o?-?-MB--oB----
---XX--o?-?---?B---X--o---MM-?-E---M-B-?B--BE-B--?--M?-?M?------BM--M--E--E----X?M--?--EMM--E-o----X?-------B--------oM-X---?--o-B-??o--B-E---o--T--o----XEX-MXBM-------EE----?---------B------E----?-B-
--B-E---o--X----B--BoM-------------M--?-?---XM------Boo?------MEMBE-B---E-B------E---X---oME-B--B---oMXB--MEM--XX-----oX--?-X----M--MT----|B-X---?EoMoE-oME-B-o--------XB--E?-----o-M-M---XBX?E--M-B----
---B----E---B----o----X----?-------X--o-------o--B--X-----BM-XM--X--E----?--E--M----X?-E----Eo---Mo-M---BE--E-B----EE--X---?-E----M-ME-Bo---M--oB-E-X---B?B---B--?-?--X-?M-------EE---M-----o--M--?---?-
-E-XE?------X--Xo?-BXo-Mo----?---?---oX----M--X?-?--B---Eo--?--?----------?---E?--X--oBT-X----M----MM?o---XB--M-----X-M--X-|----X-oB|--M-M-E------E-|M---?-?---X?-B|-M-----MX-E--M-------M-M-Eo-E-M---|v
---B?--Xo-?---E-?|-?|B--?----M-M----?-----EM?X--ETMEXM--M-E------EMB--------oMX?--B-X--o-BBE---o---MX--?E--X-EX---X-B----X-o--o-MMB-M-XM-?--E-X---M-EX----XE----B--oXB?-o-BB-M-E--M-?----X---?-------M-f
------E--o--B---T-MM---M---X--E-------------------M?--M-B--??----Xo--E?-M--M-X------BM----M--X-?--M-E-X---o---E---M--?B-o--?-??---|-M?-XB-------X-o-------?o-------|--EE-B-----B?X-X---BXB----EBXMM-?--f
-------M-o--XM--------ME-----MM--M-X---?---X-BM---E-----X--?-------E--E-?---o----E----BM---B---?---B-Xo----o-----B--o-?--M-E---?oX--oM---B-----?MX--o-----?o------ME-----ME-XB-o-M-----oMo--o-o---XB---f
----------B--o---------M--o--B---oE-----MB--M------E--B----------oo---?o----B----o----?--XE-----E-XE--EEo---B--?--E------B-?E-B----MEX-M??E-E---?EX?---M-------oX--?--ME-X-?-M--E------??B-------Bo?--Bf
---M---o--XX-----------oM----|------EMo----MoMBM---X-o--------?--Mo-oE-o---?---E-----?----?-?o-E?----B---?--oMEM--oo--o---MX--?---E-o--BBE?---?--?-?o----?---E--X--EE-TE-X---o--?---?M?B?----X-?-B--?-?f
--o---MB---X---o-----MBB---XX--MM--Mo--EE-M-o-oB------?B?M-----B--|-o--E---?--B--BX-EE-E-M-----XE-------E--B--B??----?--o---o--M-?---X-----M----?-M-??B---?-----??---o---o?XBX--E?----M---X-B-M---BX-o-f
m-----M-o-X?-E-X-???M---?---oX--EEB-E-X----?--B-?----Moo-X--Eo---oBM--X--B-o---------MX--?oo---XoE-o--?---ooMX?---X-----?---M-?-----o--E-E-B------M?X-X----X-E---BXB----XB-E--E---o?--oXB-----?----X-X-X
XXXXXXXXXXXXXXXXXXXXXXXXXXXXXXXXXXXXXXXXXXXXXXXXXXXXXXXXXXXXXXXXXXXXXXXXXXXXXXXXXXXXXXXXXXXXXXXXXXXXXXXXXXXXXXXXXXXXXXXXXXXXXXXXXXXXXXXXXXXXXXXXXXXXXXXXXXXXXXXXXXXXXXXXXXXXXXXXXXXXXXXXXXXXXXXXXXXXXXXX
