--------------------------------------------------------------------------------------------------------------------------------------------------------------------------------------------------------
--BE?-X-ME?Eo--o---------B--o--oo--oX---o--?--BB-------B-o-XE-E?---XB---BX--E-oB------o------X-X----?---MM---X---M------E----X-----o-X---?-E----B-o-E-o-E----?-M------X-?-----?---BB-------o---BB-o-----
---X--o-E-o--MX-o---M----o----o-?--X--oE----X--M?----X-?Eo-?o-BX--------------EB--------------------M--E|-o--XX-XXE--E-M-M??XEo-----------E-X--E---?---X-M--ME---?-------B--?E---E-?--X---?---X--M---B--
----M---X------E--E----M-?-?--X-M-?oB--XB--X----X--?---XBo-M---------?-M-----------BB--X----?---------M----M---B------B------BXE--B-----------o-BB-B-?--EEMBXX--BX--Xo--o-E-BE-E--?---o-X-E-?-E---EXo---
----o-X-oX?oX-?-oE---?o-------?M---M---M-E?----E--M?--?-o--o----E---M?--MoBBE-?-----|M-E----------o-?-M?---B-o--M----o-oB----X----X?------ooB---E--------E---BEX--------E-----B---X-o--oM-------?-?---M-
--M-M-------oE-o---?--o----B-X---B-o------B-------X--X---?---M---BE--|X--X-------o--MMMEX?M-o---?M-------B-------??-B-M----------M|-M--?--o?-?-M?M-B--X-X----BB-oBX-E----X------?X----o-B-o---MB--M-----
---MX--M---?------EXM-B?----EBX----??-----B?-?----X---E-----M?-o--?--------E-----Bo----Mo?B-E----BM-o--E------X----M---------?-o--E-----o------?----------oX--?E------?--X---?--EE----EB---X--T-E-------
---?o--X-B---?-??-----X---?MB?X--?---E--?-B?-------o---Eo---?-------E-------?-------B-XTBoB----E-?-------?XM--------E-----------Xo-?--X--E---E----B?MM--??o?EB--MXB-?-B-E-X-E-E--T-BE-?T--------------Xv
--X??-?--E---X?T-o----o----o----oMM---?B-E--------MX?----M-----E-??---Xo-B--o---B--o-E-B---M------------MM---M---X---?--M-MX---B-?--E-----?-----BE--XM--------Eo---MB--------XM-----B-?---M--E----M--M-f
------------X-XBM-X----X-M--?-------E-?----B----X--TX-X-B-E--E-------E?---?-B------X-?----oMo---E-M-EX---?---?--X-B-MX?---o-X?--M----X--B-----o---BX?X---EX----B-----M--------MEX-----M-MXB--oX?-E-?---f
-Eoo---EoXE---B?--o--BM?X---M-----X-B-B---X--o?----o--M-MoE-------Mo-------E---B-BBB------oEMB-X----M----?B----o----o-----M--B-E-----XE-XoX-----EE--------M--------B---BE-E-B-ME-----MM-X-----o-E----X-f
-------BM--B---?------oX--o-M----EEB?---BE-B-------o------X--?----E|--------EX-o-X-T------BB--------------o-EB---E--?o-------E--?-X--B----M----E-T?E----o-----?EoEX--------o---o?----XX--BEE--XXM-BM--Xf
--BM-MM?--oX---M?XE------M---M-E---------E---EE---BB--M--M-M--M-B-E-E-o---EBTo---|o-------M--B----?-------MXX----MBBoo--M-------?-o-E-M-oEM---E-----B---Eo----------E-B----?o-----XEB-??M-------------Bf
----X-B---------X|E-EEB-E--oBoBTooM--o-----------E----?--M-EB-M-M-X?---E--?--XM-B-?--M---o-Bo---o----o---X--XBE--B-E--?M-o-----------M?-?-XX----??---M--Bo--BXXo-XE--oX----T---?E-B--B-T-----------X-B-f
m------B-XBoo---?-----B----ME----o----EBE----E--E-?----X--M------B?M------Mo-E-M---??o--X-o-E---E------E-?----B-E---?-M-o-?-EB-Xo---o----M|-o-B-B?-X----?----E-M-o----o-E----E-M-B-XB-?B--B-X---X---?--X
XXXXXXXXXXXXXXXXXXXXXXXXXXXXXXXXXXXXXXXXXXXXXXXXXXXXXXXXXXXXXXXXXXXXXXXXXXXXXXXXXXXXXXXXXXXXXXXXXXXXXXXXXXXXXXXXXXXXXXXXXXXXXXXXXXXXXXXXXXXXXXXXXXXXXXXXXXXXXXXXXXXXXXXXXXXXXXXXXXXXXXXXXXXXXXXXXXXXXXXX
