-----------------------------------------------------------------------------------------------------------------------------------------------------------------------------------------------?--------
-------o--------------------------------------------------------------------------------------?------XXXXXXXX-----XX------------------------------------------------------------------------------------
---------------------------------??????------------------------------------------------------------------------------------------------------X----------------------------------------------------------
-----------------------B-------X-----------------M--------------------------------------------------------------------------------------------------------XXX-------------------------------------------
---------------------------------------------------?-------------------o-----------------------------------------------------------o-------------------------------------------------------------XXXXXX-
--------------------------------M-----------------------------------------------------------------------------------------------------------------------------------------------------------------------
---------------------------------------------------------------------------------------------X-----------------------------------------------------------------------------------o----------------------
----------------------------------o---------------------------------------------------------XX---------------------------------------------------------------------------------------------------------v
-------------------------------------------------------------------------------------------XXX------o-----------------------?-M-o--------BB--------------------------------------------------------????f
--------------------B----------------------------------------------------------?----------XXXX---------------------------------------------------o-----------------------------------------------------f
------------------------------------------?----------------------------------------------XXXXX----o--------------------------------------XXX------------------?----------------------------------------f
---------------------------------------------------------------------------------------TXXXXXX-?---------------------------------------------------------------------------------------------------????f
--------------------------------------------B------------------------------------------|XXXXXX----------X----------------------------------------------------------------------------------------------f
-----------------------------------------------------------o--------------------------X|XXXXXX---------XX---------------------------o------------------------------------------X-------T---------------f
m--------------------------------------E-------E----------E-------E-------Bo--E---E-EXX|XXXXXX--------XXX---------EE--------X-------------------E-E---o-------------------------------o|---E---------E-X
XXXXXXXXXX----XXXXXXXXXXXXXXXXXXXXXXXXXXXXXXXXXXXXXXXXXXXXXX--------XXX-------XXXX--XXX|XXXXXXXXXXXXXXXXX--------XXXXXXXXXXXXXXXXXXXXXXXXXXXXX----XXXXXXXXXXXXXX--XXXXXXXXXXXXX--XXXXXX|XXXXXXXX---????X
