--------------------------------------------------------------------------------------------------------------------B-------------------------------------------B---------------------------------------
----------------------------------------------------------------------------------------M?-----------o--------??------------------------------------M------XXX-----------------------M------------------
--------------------------------------------------------------------------------------------------------o------------------B-----------------------------------------------o------XX--------------------
----M---------------------------------------------------------------------------------------------------------------------------------------XXXXXXXX-----------------------------M-----?----------------
----------------------------------------------------------------------------------------------------------------------------X--------------------o-M-------------?--------o-----------B-----------------
--------------------------------------------------------------------------------------------------B-----?----------------------------------------------------?-----o------------------------------------
------------------------------------------------------------------------------------------------------B-----------?------------X------------------o-------------------------X---------------------------
---o----------------------------------------------------------------------------------B--------M------------------------------XX---?---------------o-------------------????----------------------------v
------------------------------------------------------------------------------------------------------X-------o--------------XXX-----------------------?----------------B------------------------------f
----------------------------------------------------------------------------------------------------------X-------X---------XXXX-----------------------XX----------------------------------------------f
---------------------------------------------------------------------------------------------------?-XM----X-----XX--------XXXXX-----------------------o-?----------------o---X------------------------f
-----------------------------------------------------------------------------------------------------XX???-----oXXX----Xo-XXXXXX-------------------------------------------------?---------------------f
--------------------------------------------------------------------------------?o----T--------------XXXB-----oXXXX---XX-XXXXXXX-------------------M------?????o---------------------------------------f
--------------------------------------------------------------------------------------|----------T---XXXTT----XXXXT--XXXXXXXXXXXT--------------X-------M---------------------???????-------------------f
m------------------------------------------------------------------------------------E|---------E|--MXXX||---XXXXX|-XXXXXXXXXXXX|-----EE-------XX----------E-EXX?XXXXX---EE-----E-------------E----E-E-X
XXXXXXXXXXXXXXXXXXXXXXXXXXXXXXXXXXXXXXXXXXXXXXXXXXXXXXXXXXXXXXXXXXXXXXXXXXXXXXXXXXXXXX|X-o------?|???XXX||X-XXXXXX|XXXXXXXXXXXXX|XXXXX-------XXXXXXXX--?XXXX-----------X----XXX-------XXXXXXX----XBBBXXX
