--------------------------------------------------------------------------------------------------------------------------------------------------------------------------------------------------------
---------E-------o-M?--M------------BXB---XX-oE--X-B-X-----E-?-B--oE-----MBB-----Xo----B-------o------X--X-M----?E-X-X--------MEM-E----B----------B?E-E----oE-----?--ooB?XE-E-----------?---X--------B--
-?--?oM-B-B--B--X-?B-oMEB?M--o--oEo-B----------MBM--o----B--MB-B-?B--EB----------XoEM--E-MoM-B------E-------XBMX----E--E--B-----B----E-o-Bo---M?XB----E----M--M----Bo---E-M----?-o-X----o-----Bo--------
--oo-E----?MEE--------E--E-----Mo--M-------X-o-EXB-E-B---oX-X?--BM-Eo-E---BM------o--X-------E-----X-?M?---M------B------X-------XXo----------o--EM-o-M--XM-?---oBo--o-E-?oE-----o---o--B---------o-----
----------o------M--o--?-----------o-------oE-M--o-X------E-X-X-M--E-----------oo----oM---?---E------------EBE-E--|----o-X--B----XMM-o---MB-----X---|-M--|--X-M--B-B-M-o----X-?EM--X?----E--B-X-?M------
-M--X-----XE--?-----XX--E-----M--X-?-?BBB-X----oo--BE--B-o-X--o--M-X-M?BEB---B-o---EE----XME---M--?----EE----E----E--?-ooM----------X---BoXX-----?E----X?X-B-M-EB---XEE---X-----o-?--?-?------E--M------
-B----oE--------oo-B?-o---Bo---?E---X-M-B------?--E-X--X---o-------M?-o-BoBM?MX-----EBBB-o----o--o--M-X-o-------Eo------MM-----XBo--E--XX-?X-X-E-?o---M----------------X?MM-B-----EE---?-XX--XB-MMM--XM-
-XE-EM---EE-------?-o-o-oX-EXB---B--BX--|----o-----o----EB---o-X--oo?-M--?M-B----E----X--?E-oM---TE-----o-EXMM------B?----?M-BE??MB--oE-M-B-XXE--X-X--T---B------------X?-------Eo-|-M------?-XX-------v
--oE--BX---X-B--?----EXM--o-B------o--X-----X-oE--B-o--M-M-E-----?B---E---B---EB-M----B--??-----?--o------M-B----------oo-------T--?----o-XM--E-----?-E--B?--B-B----?--X-B---?--M--BB-------B--E-X-----f
----o--B---?M---M-------BB-MBX---MM-XM-------oX---B-XXoE-----??--MB--BM-E--?Mo-------B-X-T-----X---MEB-EM----------o-?-----?------?-XB-X-E-oE-B-?BX---B?M--X-EMM---B-?-o---ME-X-Mo-M---o--X-EE--MX-B--of
-M-B-?-o-E?oXoM?M--X--Bo|?--Bo-??--oo-o-o-----MM------B--?-?---?X-?------XM--T-----X-o----X--o-?--M--X------?E--B-B-?-o----M---X--o-X----?E--EE-?-E-X--?-----EE-E--?-o---o-----EB?-----X-o--?--M--?--E?f
-M--?-----M---BB-XB-E-----------X-Bo---B---o---X-EoE-Bo-EX-?-B--MB?Eoo--E------M-M---?----M-------?-E--?BoB-?-B?----B-----M?Eo---EM-E--XE----X-M-?oX----??--B-------------E--?-|--o-M-E--?o-E--MX-M----f
------Bo------Eo-B-o-------o-o---E---X------M?--X------o--XM---E----o-X?--E-?-X-----o---E-o--X------------BEX-----o--E--?--MX-EE---?-M----o---M---E-X-E----XB-o?----B?--o-oBMB---XX-o--E?-B---E-E-?X-M-f
-B------?XX---o---------?M---M--B---B-E--X-B-B-BXM?--EoB-B-?MM----?----X-M----B-----XE------B--?B-E?------?-----------------E---o---?-E--EB---o-----Mo--?ME--ooB-M--------X--BM--X---o-XB---?-----M-?X?f
m----M--oB--MEXM-------o-?--M---X--------Mo-?------BoE-?-o--M|---M?B-MB-?--M---B-o?-M----X?---E---X------MMEE------o?E-M?X-X?E--XEE-EM--ME--XXEoBB-oX--?--X---X----B-------XX?--X---M---------B--MB--M-X
XXXXXXXXXXXXXXXXXXXXXXXXXXXXXXXXXXXXXXXXXXXXXXXXXXXXXXXXXXXXXXXXXXXXXXXXXXXXXXXXXXXXXXXXXXXXXXXXXXXXXXXXXXXXXXXXXXXXXXXXXXXXXXXXXXXXXXXXXXXXXXXXXXXXXXXXXXXXXXXXXXXXXXXXXXXXXXXXXXXXXXXXXXXXXXXXXXXXXXXX
