--------------------------------------------------------------------------------------------------------------------------------------------------------------------------------------------------------
-------------------------M-----------------------------------------------------------------------------------B??---------B----------------------------------------M------------------M------------------
-----------------------------------------------------------------------------------?-------XXXXXXX----------------------------------------------------------------------------B-------------------------
----M---------------------------------------------------------------------------------------------------------------------------------------------------------------------------------------------------
--------------------------------------------------------------------------------------------------------------------------------------------------------------------------------------------------------
------------------X---------------------------------------------------------------------------------------------?--------------------X-----------------------------o------------------------------------
-----------------XX-------------------------------------------------------------------------------------------------------------------------------o--------------X--------------M-----------------------
---o------------XXX----------------------------------------------------------------------------M-------------------------------------------------------------------------------------------------------v
---------------XXXX------------------------------------------------?------------------------------------------o---------------------------------------------------------B------------------------------f
--------------XXXXX-------------------------------------------------------X----------------------------------------------------------------------------------------------------------------------------f
-------------XXXXXX------------------------------------------------------------------------X-----------------------------------------------------------------------------------------------------------f
------------XXXXXXX-----------------------------------------------------------------------XX-----------------------------------------------X----B------------------------------------------------------f
-----------XXXXXXXX------------------------------------------------------o-----------?---XXX-----------------------------------------------------------------------------------------------------------f
----------XXXXXXXXX---------------------------------------------------------------------XXXX---------M---T----------------B---????????---------?-------------------------------------------------------f
m-----E--XXXXXXXXXX--------------------X---------------------M----E----????-------E----XXXXX-------------|---E--------EEE---------E------------E----------------------------------E----------------E---X
XXXBBB--XXXXXXXXXXX--XXXXXXXXX-----XXXXXXX--XXXXXXXXXXXXXXXXXXXXXXXXXXXXXXXXXXXXXXXXXXXXXXXXXXXXXXXXXXXX-|--XXXXXXXXXXXXo--XXXXXXXXXXXXXXXXXXXXXXXXXXXXXXXXXXXXXX--XXXXXXXXXXXXXXXXXXXX-------XXXXXXXXXX
