-------------B---o------------------------------------------------B-----------------------------o-----------------------------------------------------------------------------------------------------B-
-----------B----------o---------------------------------------------------------------------------------------------------------------------------------------------------------------------------------
------------------B----------------------------------B--------B----------------------------------------------B-----------------------------------B-----------------------------------------B------------
-----------------------------------------B-----------------------------------B------B-----------------------------------------------------------------------------------------------------B-------------
--------B------B-----------------------------B------------------------------o------------------------------------------------------B--------------------------------------------------------------------
---------B-----------------------------------------------------------------------------B----B----------B---------------------------B--------------------------------------B-----------------------------
----------------------B--------------------------o--------------------------------------------------B-------B-----------------------------------B-------------------------------------------------------
--B--------------------------------------------------------------------------------------------------B------------------------------------B---B----------B----------B---------B------------------------v
---------BB-------------B------------B-------------------------------------------------------------------------------------------------------------------------------------------------------M---------f
-------------------------------------------------------B---------B---------------------------------------------------------------------------------------B--------------------------B------------------f
---M---------------------------------------------B-B---------------------------------------------------------------------------------------B--------------------------M----------B----o----------------f
----------------------B--T---T------------T----------------------------------T-----------------------T------BT------T--------------------------------------------T-----------T---?-------------B------Bf
------------E------------|---|------------|-------M-------------M------------|-BT-----B-------------B|-------|------|-----------------------------T-----------T--|--------T--|-------------------------f
------------T--o---------|---|------------|-----------------X------T---------|--|-------T--T------X--|-------|------|-o----------T----------------|----T------|--|--------|--|---T-------T---T---------f
m-----------|--T---------|---|----T-----oX|---B--------------------|-------Bo|--|---T---|--|------T--|E--T---|------|------------|----------------|X---|---T-o|--|--------|--|---|----To-|---|---------X
XXXXXXXXXXXXXXXXXXXXXXXXXXXXXXXXXXXXXXXXXXXXXXXXXXXXXXXXXXXXXXXXXXXXXXXXXXXXXXXXXXXXXXXXXXXXXXXXXXXXXXXXXXXXXXXXXXXXXXXXXXXXXXXXXXXXXXXXXXXXXXXXXXXXXXXXXXXXXXXXXXXXXXXXXXXXXXXXXXXXXXXXXXXXXXXXXXXXXXXX
