--------------------------------------------------------------------------------------------------------------------------------------------------------------------------------------------------------
--------------------------------------------------------------------------------------------------------------------MXXX-----???------------------------------------------------------????????----------
----------------------------------------------------------------------------------------------------------------------------------------------X-----------------------------------------o----------?----
---------------------------------------------------------------------------------------------------------------------------------------------M----------------------------------------------------------
-------------------------------XXXXXXX-------------------------------------------------------------------?-------------o--------------------X-----------------------------------------------------------
--------------------------------------------------------------------------------------------------------?----------------------------------XX-----------------------------------------------------------
------------------------------------------------------------------------------------------------------B-----------?---------BBBBBBB-------XXX---M-------------------------------------------------------
----------B-------------M----------------------------------------------------------------------------------------XXXX--------------?-----XXXX--------------------------------------o-------------------v
------------------------------------------------------------------------------------------------------B---------------------------------XXXXX----------------------------------------------------------f
----------------------------------------------------------------------------------------------------------X-----------------------X----XXXXXX??---------B-------------------------X--------------------f
------------------------------------------------------------------------------------------------------M----X------------?????---------XXXXXXX------------------------------------XX--------------------f
-----------------------------------------XXXXXX---------------------------------------X---------------------o--T-------X-------------XXXXXXXX-------------------------------X---XXX????----------------f
-------------------------------B------------------------------------------------------------------------B------|------XX------------XXXXXXXXX----------------------------o-----XXXX-----o--------------f
---------------------------------------------------------------------------------------------------------T-----|XXT--XXX--X--------XXXXXXXXXX---------------------------------XXXXX????----------------f
m-----------------------------E------------------------------E--------------------------------------M---E|---E-|-E|-XXXXEXXB------XXXXXXXXXXX---E----------------------------XXXXXX----------E---------X
XXXXXXXXXXXXXXXXXXXXXXXXXXXXXXXXXXXXXXXXXXXXXXXXXXXXXXXXXXXXXXXXXXXXXXXMXXXXXXXXXXXXXXXXXXXXXXXX????????X|X-XXX|XX|XXXXXXXX-XXX--XXXXXXXXXXXXXXXXXXXXXXXXXXXXXXXXXXXXXX--XXXXXXXXXXXXXXXXXXX----XXXXXXXX
