------------------------------------B-----------------------------------------------------------------B-o----------------o----------------------------------------------------------------B-------------
---------------------B----B---------------------------------------------------------------------------------B-------------o-----------------------------------------------------------------------------
------------------------------------------------------------------------------------------------------------------------------------------------------------B--------------------o----------------------
------------------------------------------------------------------------------------o---------------------------------------------------------------------------------------------o-----B---B-----------
---o------------------------------------------------------------------BB----B---BB-------------------------B--------------------------------------------------------------------------------------------
--------B--------------------------------------------------------------------------o--------B------------------B----B---------------------------------B-------------------------------------------------
--------------------------B---------------------------------------------------B--------B---------------B-----------B-----o------------------------------------B----------------------o------------------
-------------B----B---------------------B--------------------------------------------------------------------------------------------------------------------------------------------------------------v
---o-----------B----------------------------------------------------------------B-------------------------------------------------------------------B----------------------B---------------------------f
-----------------B-------B---------------------------------------------------------o--------------------------------------------------------------------------------------B-----B----------------------f
---------------------------------------------------------------------------------------------------------------------B---------------------------------------------------------------------------------f
----------------------------------------------------B--------------------------------T--------B---------T-------------T---------T------B-B------------?---T-------B-----------------M--------B---------f
---B-------------T-----------------------------------T-----o------------B------------|---------T--------|-------------|---------|-------------------------|---B----------------------------------------f
----------B---X--|----------------T--B---------------|---T-------------------T-------|---------|----T---|----------T--|---------|----------T-----T--------|-----------------T-----------T--------------f
m----------------|------------T---|--------------E---|---|-------------------|-------|---------|----|---|------T--o|--|---------|--T-------|----B|--------|--X-T------------|-----------|------T----B--X
XXXXXXXXXXXXXXXXXXXXXXXXXXXXXXXXXXXXXXXXXXXXXXXXXXXXXXXXXXXXXXXXXXXXXXXXXXXXXXXXXXXXXXXXXXXXXXXXXXXXXXXXXXXXXXXXXXXXXXXXXXXXXXXXXXXXXXXXXXXXXXXXXXXXXXXXXXXXXXXXXXXXXXXXXXXXXXXXXXXXXXXXXXXXXXXXXXXXXXXX
