--------------------------------------------------------------------------------------------------------------------------------------------------------------------------------------------------------
-?-MM---B-oMB-M-B---XXE-EM-----oX-----o-?---------------M--MMM---E--B--M----E-X------oE-XM---X--M-X--o-M?-----------MB---B----o-X-o-----o---?o---?o----BE--E------EM-Eo-----o----M--EoM--o---X-MX--XXXB-
-XM--o-EMooM-BoBX?--o-M--------E---B--o?BX-?BB-o--M-?M--o---M-MXE----B-X----X----B--MBEE--o---M-E----E-E----B--o---o-?----X---B?oo--E?Bo-oME-------M---MM--X-MEX-oMXMo-M-BE--?M?--oE-?--EoX----B--M-o---
----E-E-M----?-M-MME---M-BE?oM-o?X---XE-M--E?----B----X-M--M?-?-----E----?--X--X?---MoMM-E-----E-o---o-?----MoBo---o----?--M?---EX----B-M---------E--?-MM?-----oM-oX---?----------BMBXXEE---E---E--?BB--
-B----X-B--X------oB----EX--B-------XMM-M------oEo-BoMBEoMXMX--EX-BXB----Mo-oo--E-----?-----B-X---E-M--M----E-B-?-MX-----M--M-B-E----X-?-M-M---------X---Eo--oMM--X?-XXM-MX?----E-ME--Eo----M---M---BEM-
-oo--?-XX---X-BE-----XBMM-EMoME-B----X-X-BX---XEo--Mo--------?--M----ME?o?-----E-XBo-E-o--E?B-XX?E-o-X--o--o-M-X-----------M---?E---o--M-----X---o-X---?-ME---E---X-M--o-------MX---Eo----EMXM-?-B----X-
-M?--?X-EM-oM-B----?--------MXM?--MoXM-o-?--?o-MM-o-M-?--o--E?-----Xo---X--EB---oB----X-----X-BM-----Xo-?EoEE-MM--M---B-M?BXoo-------o?BB----EM--Bo-o?-BE-o-M---------E----o-?M-----B--?----B-E-----XM--
--MMEB--Bo---?---X---M?------E---M---?---E?-?oo-----M--B-M-oB-E-oM---oB---o?X-----E---E-B----BB-??-E---B-?oXE-B-X-X-oM?o-o-MB--MX------X-----B-MBEo-BM--X-M--------M---?-XXo--X--?-E--?XMB--M-?--o-M-M-v
-E-MM---MB-EoM??--EEoo-o------E--B----oEX-MX-M-B--M-E----ME?MEE--E---ME-oM-EX?----------M---E--oM-?-E-B?---E------o--M--E---M--MB?-o---B-M-Eo----?-E-o------o----M-?-B?--E-M?--?--o-M-oE-MooX---E-----of
-?--E---?--E?M--------MM---B----E-------B--MM-M--?-oM?-------BM---ME------E-MoM-------Eo-M------oB----EB-----M--?-o----M--M--M-B---M-B---XM---?-MEo----MEX?B-B--M--o--?-E--BXE----B----?o-MEoM---X-B-?Xf
--M-B-oB----B-o--M?--MM--M--M??-------------Eo--Mo-X-----o-ooEoE---o-EE--oXX---?--?-M??Eo--Mo---BMM------B-oM--EE-X-o--E--o-ME-o-M--E-?Mo-o--?----------XBXM-E-B-E--X-?-B-X-----M--X--E----E---BB--M--Xf
---XBB--B----B--XX-M-M-E-----Bo?-o--------M----?--E?--XMM-M-BoMMX--M?----o--oE--------oXM-o----B--M-?--Mo-B------E--?-----?o---EB--E-E-E-----E---Mo----E-E--X-XM?MoM-M----XBMM-M--M-X--X-oMB--EB?--M--?f
---M---EM-?X--M-MXM-----B-------MM--X-----BB-oo-B-?XMB-M--------B--E--EMB--E?-M------E--o---oBM--?-M-M-B-----E--?-MMB---X------XE--E-MMM---o-ooB?X---X----X-M-----MEXX----B-?---oBE?------X----X--oo-B?f
-------XB-----M--??M---Eo-o-M-X-?E-XoB---M-M----X----BM-ME---o--?-?---BXoM-?X-EM------E---M---B-M-------EB?--E--X---o-MEME---o----?---M---XBM-?M-E---E-?--Bo-E--Boo-o-M--o-?o---E?----X-E---BX--MM?--E?f
m--BBE-?M---MM-?---BBM--Bo?-X?--MoM--?M---BBM-Bo--o--BM-E?--B-BB?M-B---MM-M---X-o----X-X?--E---Mo-E------------E??-------?-E-----X-----------o--M-?-o--M-E---M---o-E--M--ooM-X-oE--??BE-o-o--B----B?--BX
XXXXXXXXXXXXXXXXXXXXXXXXXXXXXXXXXXXXXXXXXXXXXXXXXXXXXXXXXXXXXXXXXXXXXXXXXXXXXXXXXXXXXXXXXXXXXXXXXXXXXXXXXXXXXXXXXXXXXXXXXXXXXXXXXXXXXXXXXXXXXXXXXXXXXXXXXXXXXXXXXXXXXXXXXXXXXXXXXXXXXXXXXXXXXXXXXXXXXXXX
