------------------XX--------------M----------------------------M------------BB-------------------------------------o-----------------------------??????----------BBBBB----------------------------------
---------------------------B--------------------?----------?--------------------?????-----?------------------------B------?-------------------------------------------------------o---------------------
--------o---------------------------------------------------------------------------M---------------X-------------------------B-----------?----------BXXXX----------------------------------------------
-------------------------------------------------------------------X----------------B---------------------------------------------------------------------------------------------------------------o---
-----------------?----------------------------------------?-----------------------------------------------------------o----------------------------------------------------------------B----------------
-------------------------BBBB-------------------------------------MBBB------o--------------------------------------------------B------------------------------X-----------------------------------------
------------------------------------------------------------------M----o-------------------------????-----------M------------------M-----------------B---------------------------------M----------------
----------------------------------------BBBBBBBB-------BBBB--------------B-----------------------------------------------------------------------------------------------------BBBBB---o-----------XXXXv
-----------------------------------------------------------------------------X-------------------------------o---------------------X------B----o----????--------------------------------------------X--f
---BBBBBB------------------------------------------------------M--------------------------------------------------------------------------------XXX---------------------------------X--------------XX--f
------------------------------o-------------------------------------------------X--------------------------------------------o---BM-------------------------------------------------M---X---------XXX--f
--------------------------------------------------X-----------------o-----------------------------------T------------------o----X-----?-----------------------X-----------------T-------XX-------XXXX--f
---------------------T---------------BB----------XX----------------XXXXXXXBBBBBB----------B------------B|---------X------T-----------------------???----------XX----------------|-------XXX-----XXXXX--f
---------------------|--------------------------XXX--X---B----------------------------------------------|------X-----????|?-----------------------------------XXX---------------|------TXXXX---XXXXXX--f
mE-------------------|------E---------B--------XXXX-XX-E----E------E---------E-----------Eo-----------E-|---E-XX--E------|-----???-----M-E--------------------XXXX--------------|---E-E|XXXXX-XXXXXXX--X
XXXXXXXXXXXXXXXXXXXXX|X-----XXXXXXXXXXXXXXXXXXXXXXXXXX---------------XX-o---?-BBBXX-XXXXXXXXXXXXXXXXXB--|XXBBXXX---XX----|----X----XXXX------B------XXX---?---XXXXXXXX-XXXXXXXXX|XXXXXX|XXXXXXXXXXXXXXXX
