--------------B----------------------o------------------------------------------------------------------------------------------------------------------------BB--------------------B-------------------
-------B--------------------o-----------------------------------------------o---------B-B-------------------o---------B--------------------------------------B------------------------------------------
-------------------------------------------------------------------------------------------------------------------------------------------------------------------B-----------------------B-------B----
--Bo-----------------------B-B-------B-----------------------------------------------------------------------------------------------------------------------------------------B------------------------
--------------------------------------------------------------o----------B--------------------------------------------------------------------------------------------------------B---------------------
------------------------------------------------------------B----------------B-------------B------------------------------B--------B---------------------------------------o-----------B----------------
----------------------------------------------------B-------------------------B--------------o--------------------------------------------------------------------------------------------B-------------
-----------------------------B--------------B---------------------B-------------------------------------------------o------------------B-----------------------------------------B----------------o----v
-----------------B---------------------------------------------------------o------------B----------------------------------------------------------------------------------B---------------------------f
---------------------------------------------------------------------------------------------------------------o------------------------------------------------------------------------B--------------f
---o-----------------------------B-----------------B--------------------------------------------o-------------B------------?---------------B----------------------------------------------------------Mf
-----------T----T------T-------------------------------B-------------------T--------B-----T---------------T---T---------B-------------------------------------T----------------B-----------------------f
-----------|----|------|-----------T-----------------------------------T--M|----------T---|---------------|---|-----T----------------T-----------o------------|--------------------------------T-------f
-----------|----|------|-----T-----|--XT---o------------T--------------|---|----------|-?-|--X------------|---|-----|--------T-------|B--T--------------------|------------------T----o--------|-------f
m----------|----|------|-----|--T--|o--|----------------|----T-----T---|--o|----------|---|---------------|---|--T--|--T---B-|-------|---|---------T---T------|--T-------T-------|---T---------|-------X
XXXXXXXXXXXXXXXXXXXXXXXXXXXXXXXXXXXXXXXXXXXXXXXXXXXXXXXXXXXXXXXXXXXXXXXXXXXXXXXXXXXXXXXXXXXXXXXXXXXXXXXXXXXXXXXXXXXXXXXXXXXXXXXXXXXXXXXXXXXXXXXXXXXXXXXXXXXXXXXXXXXXXXXXXXXXXXXXXXXXXXXXXXXXXXXXXXXXXXXX
