--------------------------------------------------------------------------------------------------------------------------------------------------------------------------------------------------------
-oo--E-MMM-MB-E-??--?-XEB?----B--E--o-o?-M--E---E-X-?--X-oEo----B?--E-XM----oX-M???--XMoB-EM-?BoXEX-----X--EMoBX-X?--M-M?-MB-M---?--?-EXoM-E-----oBM-EXM--EXEB---E---oMo--EX-E--?-X-o--B-?----B---EX----
-o-oM|BoXo-E-E-MX--MEo----ME--XM-|M--X-----X-?-B|X--?--?-TXE-----|X-o---oo--X?EB?-o-?-EX??-B---X-|---M-B---E---EE------T--T-ME---|-X-M-T|-E----EM-|-?-E-MM--T?BE--EB---o---M-M---E-Eo---Bo----|E-XB--?--
-XEoT|-X-E?--M-M---MB?-B-E--M?--B-oMBo---B-----?-BXM|MBM--B-M-X-B-T-B-EE---B||MME-E--?-E--M-oM-E-XM--TB---EB--ETEXX---Mo-oE----?E---B-------BE-Bo-EB|-|--To-E|-E--T|-?-?X---E?E--X-M-?-?MX?E-EoE?---Boo-
--MEoE??o--Mo--E---BE-?---MoE-B-M-----XB-X--M--B---|--o-?-----B-Bo-oo--B----MMEMo--M-EXX?o-X?M-?-B?---oBB-o-BX-EE--?---B-BT--X-T-EB--E-o-M-Mo|XE|X-TMo?E?-o-M?---B--?---TMo-T----?----o--MBo--B-T?---o--
--B-|E---o-TM-BBB?o-E-T--E?--E?-oo-oo---B---M-BE---Bo---------B-?--XE-ME-?E-?-o-E-X-E-?E--?-TX-M?-oE-oB-T-E-M-?X----EX-?M--XM--TX-BE-EMXBE?-oM-X--o|o|-TM-B?-EoBM|-EB----o-BX--MM----oo-----EE-o-|M--oX-
-BX---X--M?X-?E|B?|XT--?-?-XXo---?o-M-----M----Xo-B?Bo-X--o--ooEo-??M-?-X-?B----MB|B---E--?-E----ooM-?ToE-M---E?-M?--E-E-?M-E---oE?|B-?E-E--B--|E-?MM?--X----XBT--?-X-E-o--|--BM-o-o-M---B?---X?B-B-E-E-
-E-BE?X-M--M--?E---??X?o-ToTXBoM-E-X-??--?X----o-B-B--?-X---XB-MBMBXXXTEX-oX--B-?--o----o?-XM-EoMEX-?-?-TBB-EBX??oo--BBE-X-B-?M-oo-B---oXT--BBo--XX?-T-XT--E-Bo---E-?B-Bo??-X-B?-M-o--?-B|-BE---MET--M?v
-B---ET-B-XBE-oo---?E?---M?-TXM--M-X-?---MX---X----|BMo?-?MEE?BE|?oo-Bo-T----B-MB--?-?X-MX?-XBE?-o---?|ET---?-TE|--o?--?M-M-ME|-XE-M--X-?XMoEMEMoM--B?M|EMM--X|BXX?M-MXXMooo|-TBEo---?M-----B-oM--?-XX-f
-----?B?BE-?M?TM----o-oBX-EB-|B-?-?B-M--ooT----o-METXMX?Xoo--o??E--oo|BE-XoM-o-B--BMMM--X----EEoB?M-o--E--E-?-E-MEXBMo-B|?o--EM-B-X----B-|BE----?oEM|EMX-M-B-XM-?B---X-B-T-X-?XBE?Mo-MM-B-X----?X-----Bf
--o--o?B--X-BT|-----M-TT-X?-----E?B--BooB-?E--X--------------M-X|---o-MT---Mo---ME---?--XMo-M-?o-MXBB-?B-----?oo|-|T-|-X---o?|X-o--E?oX-X--o-M-X|--E-?ME-BXXo--XEo-?-B-|---MEMo-E--XM-XEE-T-----Mo----Xf
---B-ET-oM-M--M---E----B--o-X--EBE-EM----B---E-E---?-M----XB-BX--E-o-----EXE|EMB--E-EMX--oB----?-?--XX-MM----|BE--EX---?ooB--EMXXX--BB|B--M-MX-oo---oTM-M-----EBB-?---?--?-TMo?---o---MB-BE-X----oM----f
--?Bo-EB---BEBMBo---?BB?B-TX----T-?MX-M-MB-EMo?-X-?|?M---XXMB?MX--------X-X-MTET--TM-E---|EMBM--X?---X---M-X?MMXBM--??E----?--XEoX-B|-o?E-BoE?-X--E---X-TXE--o---BMM-BME?-XB---o-?XEoM-o-X--E--B--X----f
----oX-EX?EX--MMMo---|-BE----X-X--B-BoM-M?XX?o--E--XXXB?-MToB-EX-B?--?--X-oo|-M-XXT-M--M-oo---o?-|X-?E---B-X?MMT|-o-M-T--o--MB|?X-?TBM|?|E-o-o?---E---Xo|M---o--M?------o?-TBMo?M?-MM|BX??-----X--EXEo?f
mB-o-MMX--XB--oX-EoE-|MME----M---oM-E|MoE?--|?-MoXEXM-oEB-|----?------BEXB-B-oo-o?---BX-?MM--?E--ooX?-X-----X-EB?------o-E-o-B-Xo--?-MToBXEE--X??E--EXo----o-----B?M-oX---ME?-E|XM--BX-|ME------BB-MMooX
XXXXXXXXXXXXXXXXXXXXXXXXXXXXXXXXXXXXXXXXXXXXXXXXXXXXXXXXXXXXXXXXXXXXXXXXXXXXXXXXXXXXXXXXXXXXXXXXXXXXXXXXXXXXXXXXXXXXXXXXXXXXXXXXXXXXXXXXXXXXXXXXXXXXXXXXXXXXXXXXXXXXXXXXXXXXXXXXXXXXXXXXXXXXXXXXXXXXXXXX
