-----------------------?---B-----------------------------------------------------?------------------B---------------------------------------------------------------------------------------------------
----------------o--------M------------o----------------------?------------------------------------------------------M--------???--------------------M---------------------------------------------------
--------M----------------------------X--------------------X-------------------------------------------???-------------------------M---------------------------------------------------------------------
--------------------------------------------------------------------------------------------------------------------------------------------------------------------------------------------------------
------------------------XXXX---XXXXXXBBBB--------------------------------------------------------------------------------------------------------o------------------------------------------------------
--------------------------------------o---------------------------------------?--------------o----BBBBB-?-------?---------------------------------------------------------------------------------------
----------------------------------------------------------------------X-------------------------------B---------------------BBBBBBBBBB------------------------------------------------------------------
-----------------------------XXXXXXX---B---BB-------------------------XX-------------------------------------------------------------------------------------------------------------------------------v
-------------------------------------------------------------------BBBXXX---------o---M---B-----------B---o---o---------------------------------------------------------Bo-----------------------------f
--------------------------------------X-------------------X-----------XXXX----------------------X----------------------------------------------------?-------------------------------------------------f
------------------X--X---------------------------------o--XX----------XXXXX--B------------------XX?---------------------?????--------------------------------------------------------------------------f
-----------------XX--XX---T-------------MM-T--------------XXX---------XXXXXX-X--------X---------XXX--------------------------------------------T-----------------------------------------?---------T---f
----------------XXX-TXXX--|---------------?|-------------TXXXX-----T--XXXXXXX---------T---------XXXX---------B----------B----------------------|---------------o-----------------------------------|---f
---------------XXXX-|XXXX-|----------------|-------------|XXXXX----|--XXXXTXXX--------|BBBBBBB--XXXXXM----------o-------------------------o----|---------------------------------------------BBBBB-|---f
m-------------XXXXX-|XXXXX|-E----E-EE------|---E--E------|XXXXXX---|E-XXXX|XXXXBB-----|--------EXXXXXXE------E?E------Eo-----------------------|-------------------o----E----E---------------------|---X
XXXXXX?XXXXXXXXXXXXX|XXXXX|------XXXXXXX-X-|XXXXXXXXX----|XXXXXXX--|--XXXX|XXXXXXXXXXX|XXXXXXXXXXXXXXXX---X-XXXXXXXXXX-XXXXXXXX-------XXXXXXXXX|XXXXXXXXXXXXXXXXXXXXXXXXXXXXXXXXXXXXXXXXXXXXXXXXXXX|XXXX
