--------------------------------------------------------------------------------------------------------------------------------------------------------------------------------------------------------
--?-----XE-----EMB--?XM----?M-X----BEX--?---E----------?M--E--o--Xo-o?-----Xo?---M---?---EX---o--?-------M----B-E--E------?-------XX--?X-??XMo-o---B-B----?E------?----o---B--B----ME--------?--o-------
-B-M----X----XM--Bo--X------?---B-X--------M--M----?-BXE-------B-B-------o----B-o--?o-XEoX---oo--X-----E--o----??-o--E-X---X-MM-?-----------X-BM---EE-EM---o--E----M----BXXX-oo---?--E-??B---?-----EX---
-M-E-EXoX----?--o-BBEo--o?-B--M---EEXX---oX----XB?---------X-??XB--EEo--MX-E--E----M--X?--?----B-MX--?-?M?--o?M-----o---?E?M-E--B-----Bo-B-XXE-----??-E---BM-X?XX-M---oEB?-E-----o-oB--M---MMMo?---B-Xo-
----?BBX----Bo-?E--Xo-B-B-----M--E--T---X----M-?--BM---M--BX-E--X--X----X----?-----------oo-B?-B-?--E--XEME-BX--X-----o--EM-B-E?-----E------o------X-Xo----BMM---E-?-XE?---------M--EB---X-------M----o-
--M-M?B---X--BM---B-?----?--MXMM?---X-B----M-X--M---M-B-MMX-X----E------EM------B?---------?--E?---------o-?----M-B--MX-X---?---B-?-M---B----E-MBEMBoB-E-X------B---EBo--o------------?------?oX-?-X--?-
-B--XB?-?---Xo-B---ME-B?--o--E-EX----X---?--------------o-X?M---o-----B---B-EB-o--M---Mo-----X-o--E--?ooE--M-?--M--BEoB--------oX--EEE-X-----MXM----?-------B---oEE----------o-BM-E?-XM--?--E-----X--X--
-B-E-----oBEM-------MXB---o--BE?-o?E--EM---------M--o--M--?XB-?--XE-----M--B-M---B-E-?o--B-?-Mo?-X--BEB----Bo--o--M------------o----T?BBX--X-M|--E?-E-E-------EE----M--X--Mo-E--B---o-BM-M--?-----?--Mov
----------B?-oo----o----o---BM------oE?---------X?-?E-B------MB------?--o-XoX-?M-MX-E-XX-?M-B-o-?-BB---BM--?--X--EE----BM-M----B----X--?-XX--MBX?M--MX---B-E-o-M-o?-E----Mo-----M------MX-M--XE---M--o-f
--------B?oo-?--X---B---oo---MoM----------X----?--M---E--MB----?M-ME-MBM-----o---o---Xo--M-?----------o--MB----------BoE----EM?-X-o---o----M-?--o-M-E--o---M--o-M-o-E---B---o-XM?--EXXE-?----X--E--M-Bof
------EXM-E-M--M-o-E-E-E-o--oBB-o---MMX---B-X-?---o?B-o-EEo---------------MEo?B----Bo----B-Xo-?---o-E-----------BM---X--X--EE---B-----X?----M--BE?--o?--o?X-M--EXE-o-X-B?-B--o-?---?----MooM-MME-EX---Mf
-B-------B--|----X-XE-E--------oXMoE----Xo----?-X-o--?--E----------XooX-----X-M-?B-M---o--B--oMXB-X-?-?E-M----B-?E?o?Bo-X--E-BMB?-----M--E-Xo-------E-M--EM--X-X--E--B?-?-------M-oBBXM--M-oE?-----B---f
-EEX-------B--?B--X??E----o--EMX--X-------?B-?BB--M-E-XB--?MB--o-X--??-----oMB--B---EB--B---E-----XE-oM--o----EB---X----?--M--XE-----oX------MM-E--M-MME-----E----BB-o---B-o----E-M---B----?-?-X-B--B--f
--X--o-M----M--X--M?--X-B-M----o--------EMo---X--?-----------B---o-E?----?-----X-M-----X---X??-B---oE-X--o?M--E-M-E---E-B--EE-------o-----------?--Xo----BB-?--B---------BXE-----E-oo------To-XM-?o-?X-f
m-M--o-M------o---B---M--?--M-----E?E-X--------B--E------?-B----o--oBXo-M----M----o------M--oB---X-EBEM----E-?M-BB----M-B-----E--XM---B?o----M--X-------M-----M??-??------EB----X---E-----X-E-X----MX--X
XXXXXXXXXXXXXXXXXXXXXXXXXXXXXXXXXXXXXXXXXXXXXXXXXXXXXXXXXXXXXXXXXXXXXXXXXXXXXXXXXXXXXXXXXXXXXXXXXXXXXXXXXXXXXXXXXXXXXXXXXXXXXXXXXXXXXXXXXXXXXXXXXXXXXXXXXXXXXXXXXXXXXXXXXXXXXXXXXXXXXXXXXXXXXXXXXXXXXXXX
