--------------------------------------------------------------------------------------------------------------------------------------------------------------------------------------------------------
--M?-EM?------M---MB?-E?X-E--o---------------oo-------?--B---o--?-?----E-?-oM--X---o----XX-BM--o-------?---?------M--X-B--X-X------oB----ME--B---B-X-B?--oE---o-BM-X-X?-E-E--B-B?-o--B---o-?--o-E----?M-
---EM-----X-E-------M--B--Bo-oBE--B--XM---M--B--------BM??-oEMB?BB--B--Eo----M-------o--XX--E---B?M?-BoEM?M---M?----ME?o---B--o----o---MB--XX--------?XEo---M?MX-----X-oE--M--EX-M?EMME-o-EM-------M--|-
----X-M-M--------X---X--o?---o----B-METXX-M---EX--BX--X---X-----??-X-M-----XX---o----X-X-E--oM--oBE------o--oBEo-EE--XM---X?-o-XM-?------B-M---?E--o-------E--X--B-o---B-B-B-o-|--M----?E-B-?-Mo---E----
---X---oE??-?-o--?-X-EB-E-M-B-o---M--BBo?--------E--M?--o-X-M-----?-M--?----?--X-B--B-XEMM--|X-M---X?-o----ME-X?E----oM----?XB-E-M--?o-E--------M--------EEXo?X---o----ME----M------oM--B-----------?---
--B--?----BX--o-BXM--M--Xo-?-B--o--X---?--?---------EE--MB-?---?-BE-B-----B------o-----o----MB-o------X--oM-Mo-XXX--?-?XB--------ME---?-----B-o--?EB--Eo--E-B--M--X--M-X---Eo--M----M-?-E-EB-oX?---B----
-B-o-----------o--?B--X--|-----M---M-B--BE----o--Bo----M?----BM--o--E-------M----B-Mo-------EX----------EEB--?BB-X-EEE-X---?B----XMB-EBBE-BB-?EoB-X-X?--B--M--B---oM--?-?M---?--------M-o-M-?E-B-M?-?-E-
-EMXBBM-----XE-?BE-X-o-Bo--?E--------o---o-M--XMo?-BB---E---?-o---EB------?--B-B-B---M----MM---M-E---?B-o-X?--M--B--X-M--X--M-----oBM--MMM-E---EX-o------X-X---EEX?|----o--------E--M------B--B-E-M-XM-v
--?M---XX-?--XE------o----BX-MX----------?E--X---T---M---MEX-?---EM-?------Eo--o---o---B-oXM-M-o-XM-M-BX---X-B--M--o----------oBMMBTM-XM|---E-E--?--E------Eo-o---|oBBE-E-XB---E-o---B-?---BooE--?-BB--f
---o--B----X-?-----E---M--------??-o--?X--BXo----oM-EMM-B-------EXE--------MBX-o---E-M----o-?M-?---o-----?------------M----B-??E-X|Moo--oo--X-----o?-------oX----B-|--EE-B-----B-X-oE----B-?-oE--?M--Eof
----B---oE-X-?o-X--|-o------------B?--o?---E--MX--E-oXE---X--B---o-E-EE--M--o-M--B-------oXB---?------o?---X--o--o--oB------E--?BBo-o--------o--MX-oX-E---?o?--o----oEE--?E-XB?o?---?--MM?-oM-E----EEX-f
---E----X---------X-o--M-B-o-BM-E-E-----MB?--X-Bo--M--BE----------E-X-----M----B-oM---?B-X---B-E--?--o-E--MEo--?-B------E?--XXB?BB--------E---------?MEMB---B--o---????--X---M---------B-?-----?--M?--Bf
-B-------BXX-?-?----T---M--T-|---o---M-----o-X-M-?---XE--X-E---X---?-E----E---?MME--B----M--MoE?B--EMX---?----EX---BM-?Mo-E?-BE-o---E--o-E?-B--o??o?o----o?---------E-T--B-X--------?M?-?-o------B----?f
-M---------X--X-----X-B----?---BME-EB---E-BM--oE--E--MEB?-----------oT-M-------o--o--E--------XXEXoX----?-M-o-???---o--B-?-Eo--?o----------M?M----M-?----?M--?---?-oMo-----XBEX--?EME----oX-B-X-MM---o-f
mo--B-o---XEo-----M---X---X-oX-?-E--T-X-o-----o--M---M---BE-?E-----MB-E-ME-Mo-ET----X---o------B-B-?-E-EM-o--E-?----oB-EE---o-------o----X-B---M-MM---------M??--BXBM----BME--E----?----B---B-?----X-E-X
XXXXXXXXXXXXXXXXXXXXXXXXXXXXXXXXXXXXXXXXXXXXXXXXXXXXXXXXXXXXXXXXXXXXXXXXXXXXXXXXXXXXXXXXXXXXXXXXXXXXXXXXXXXXXXXXXXXXXXXXXXXXXXXXXXXXXXXXXXXXXXXXXXXXXXXXXXXXXXXXXXXXXXXXXXXXXXXXXXXXXXXXXXXXXXXXXXXXXXXX
