--------------------------------------------BBBBBBBB-----------------------------------------------------------------------------------------------------o-------BBBBB----------------------------------
----------------------------------------------------o------?----M---------------?????----------------------------------------------------------------------X--------------------------------------------
-----------------------------------------------------M------------------------------M------------B----------------------------B----------------------BXXXX---------------------------------o------------
-------------------------------------------------------------------X----------------X-----------------------------------------------------------------------------------------------------------------?-
--------------------------------------------o-------------?--------------------------X--------------------------------o---------------------XXXXXXX----X------------------------------------------o-----
-------------------------------------------------------BB---------MBBB------o-------XX------------------------------------------B-----------------------------X------BBB--------------------------------
------------------------------------------------------------------M----------------XXX--------------------------o------oM------------BBXXXXXX-B------------------------------------------------------?--
---------------------------------B------------------------------------------------XXXX-------------------------------------------------------------------------------------------------------------XXXXv
---------------------------------------------------------XX--X-------------------XXXXX---------------------------------------?----------------BBBBBBBB-?----------------o------------------------------f
--------------------------------X----------B-M---------X----XX------------------XXXXXX------------------------------------------B----------------------------------------------------------------------f
-------------------------------XX----------?---------------XXX-----------------XXXXXXX---------------------------------------o---BM-----------------?--------------------------------------------------f
------------------------------XXX----B----o---------------XXXX----------------XXXXXXXX--?----------------------------------o----X-----------T-----o-----------------------------T----------------------f
-----------------------------XXXX----BB-----------B------XXXXXo--------------XXXXXXXXX----B-------------------------------------------------|---------X-------------------------|----------------------f
------------------------????XXXXX------------XB----T----XXXXXX--------------XXXXXXXXXX------------------------------------------------------|-----------------------------------|----------------------f
mE-------------------------XXXXXX-----B-----XXE----|---XXXXXXX-------------XXXXXXXXXXXE--E-------------------------------------E--E----E----|------------------------E----------|-----E----------------X
XXXXXXXXXXXXXXXXXXXXXXXXXXXXXXXXXXXXXXXXXXXXXX-X---|--XXXXXXXX-------XX---XXXXXXXXXXXXXXXXXXXX---?------X-----XXXX------XXXX-XXXXXXX--------|XXXMXXXXXX--------XXXXXXXXXXXXXXXXX|XXXXXXXXXXXXXXXXXXXXXXX
