--------------------------------------------------------------------------------------------------------------------------------------------------------------------------------------------------------
-----?-o---B-?Eo-?------X--MB?E-o------o-E--oB--B-o-M-BoE-----o-E----B----X-----o-o-?B-----M-------M--o---M--X---------o--X----B-o-o---ooMEB-B--X---E----E-------o-?---E?---o-M---XX------------XXEoE---
----X-X|--X--X----BM--?------E-?-EE??o----o------?o--o----X--o-X-o-oB--BXB--M?E----?--B-------o--?o-?E?---XX-M-X-----------M---o-oX--o--X-E------M---?-?-M--X--E-XB-BX--XB-XBoB--M---M--------??-----o--
-B--o---E---MBX----X-X---XEX-TEX-BBM-|-?-B-o-?-?---o?oE?-oM---X---M-??-MM-??-M--X-M-E--M---E?EE-E?----M-E-X|-X-oB---B-?----E---E-B-M-M?Mo--B-o--MMo-M---------EB-M-EE--o---?-o--E---B--o--MX-XEE-M-?oB--
-o-?--B-M-oEE------E-EBX--|----B--X----?-M-M-B-o----o-M-MXM-X-BXX-----o----B---?-?M---B--B---X----B--E--E-T--EX-T---o---B-M-ME--M-E-E----oB----o--?--oE--B--MMB----M-XM-X---?-E-TMB-B--X--B-------o-o---
----BMT-E----------B----o--E-Bo-o----BM--EBB-?oB-------oX---EX-EooE-E-|---o--oE-X----E?MX-BE-E---o-B-oBB---M-----?-?-BB-----B----Xo---X-o-E-oB--MEB----BoM?M-X----?X-------Bo--M-?o?----o?-oX-M------E--
-----?Eo-?--MBM----M?-----o?o----E----o----E-?-o-XMo-----M---XXX-B-----o------Mo-E-M-B--M-B?--M-----?X--E--E--M-----o-B?-------oBE-o--E-o--M----Eooo----T-E---XB---------M---?--X-EoEX--X--M-B--E--E--E-
-----Bo-----E---E?o---B-M-XB---X---EE-----?--MXX-------B-oBX---B-?-B-B?|--o---E|--?-X-E--o-EB?-?X---M-----Mo----XXE?-?M--------o----BoM--X--ME-E-E-----o--?X?-MXEoX-Eo--B---M-----oXo---XE-----o--BX-?-v
-X--oM--M-?-E-BM?-X---EBo---o-B-o-------B--EM------oB-X--E------B-XBB-o-X-------M--o--MM--Mo?oE|B---M----MX---?B-X----X-o--oBM--B?-o--?-B--------------Bo-B-?BX-----X--Xo-B----M--X-----B--?-?-X-Mo--E-f
--o-X---------------?---?--E--?XE-------X---M?-----XMBE-X-EB----T-EEE-X-o----o-E-o--o-M------X--E-o-T----M--B--oE---X-Bo------X-oE----XB-E----M-M------M---XE--B----T-X--M-o----?----M-oMMMT-X??-X-?X-?f
-?B--o-M---?--X-B-?EoX----?---------E--EMoB-?B-----M?E?-M-EoMM------oEo-------?----X-----M?-M-M---M-----X---X------B---X----B---E---o?B-M----X-X------oB-EM|-E---E--X-M-oEB-BE-----XM----XoME-?----oBEXf
---E---------X--o?--oEXX?--B--M-M-o-BMoE?---E-Mo--BM-M--M-X-ME?-EM---B------ME-o-------?E-oMMB-----B--M-oB------M----M---X---oB-M-X--E-----B---?-?B--------?---?X--B--E-o----M------B--E-XEE--o-EEB-T--f
---MEoB--B-o-----o--E-----B-M--XBMM----M---------X-T?X-M---?-?XE--?--B---X?BX--EXM-o---TB-B-E-----M--B-o?---B-----E-?-?oXEBE----M-X-Xo---B--?E--MB-M-BX--E-|-E------------M---MME-XEB---M--E?---o|--X--f
-oo---?--M--BB------o---M--B---XE-|?---o-EEB?-B-E--E---MB--M-X-------MXEX-----B--MoB--?----?-----M-MBX--M-BE---------o------o?X---Xo----B-MM-----XXM----E-M?-MB-----E-------E---?B-TX-o-o-X-?XXEBM---E-f
m-|?-X-EB--o?-XX--M----MXM---o---E-----EE--E----X--X---?---B-o-------M-?B---E----o?B---B--X--oM--M----EX---M------B-XX--BX-oXB----------MEo-EMB--Xo-oM--------MEM--B--------B-ME--BE?-?---------X---EXoX
XXXXXXXXXXXXXXXXXXXXXXXXXXXXXXXXXXXXXXXXXXXXXXXXXXXXXXXXXXXXXXXXXXXXXXXXXXXXXXXXXXXXXXXXXXXXXXXXXXXXXXXXXXXXXXXXXXXXXXXXXXXXXXXXXXXXXXXXXXXXXXXXXXXXXXXXXXXXXXXXXXXXXXXXXXXXXXXXXXXXXXXXXXXXXXXXXXXXXXXX
