---------------------------------------------------------o---B------------------------------------------------------B----------------------------------------------------o------------------------------
-------------------------M------------------------------------------------------------------------------------------M-----------------------------------------------------------------------------------
-------------------------------------------B-----------------------------------B-----------XXXXXXX------o-------------------------------------X---------------------------------------------------------
----?-----------------------------------X--M-------------------------------------------------------------------------------------------------?--------o-------------------------------------------------
-----------------------------------o-----------------------------------------------------------------------------------o-------------------------o---------------?--------------------------------------
------------------X--------------------------------------------------------------------------------------------------------------------------X-------------o------X---------X---------------------------
-----------------XX-----------------------------------------------------------------------------------------------------------------------------M-o--------------XX-------------M-----------------------
---o------------XXX--------------M------------------------------------------------------------------------------------------------------------------------------XXX----------?-------------------------v
---------------XXXX------------------------------------------------?-------------------------------------------------------------------------------------------XXXX-----Bo-----------------------------f
--------------XXXXX-----------------------????????------------------------------------------------------------------------X----------------?---------?--------XXXXX------------------------------------f
---------B---XXXXXX----------------------------------------------------------B-------------------------------------------XX-------------------------B--------XXXXXX------------------------------------f
---?-----X--XXXXXXX-----------------------------------------------------------------------------------------o--o--------XXX---------------------------------XXXXXXX----------------------?---------T---f
---------XXXXXXXXXX-T---------------------------------------------oT-----o------------------------??-?-----------------XXXX--------------------------------XXXXXXXX--------------------------------|---f
---------XXXTXXXXXX-|---------------------------------------------B|--------------------------------------------------XXXXX----------------------------M--TXXXXXXXX----------BBBBBB----------BBBBB-|---f
m-E------XXX|XXXXXX-|----------E-E--E--X---------------E-----------|-------------------------------------------------XXXXXX----------------E---E---E-----X|XXXXXXXXo--------------E----------------|---X
XXXXXXXXXXXX|XXXXXX-|XXXX-----------XXXXXXXXXXXXXXXXXXX--------X-MX|XXXXXXXXXXXXXXXXXXXXXXXXXXXXXXXXXXXXXXXXXXXXXXXXXXXXXXXXXXXXXXXXXXXXXXXXXX------XXXXXX|XXXXXXXXXXXXXXXXXXXXXXXXXXXXXXXXXX----XX|XXXX
