------------------------------------------------------------------------------------------------------------------------------------------------------------------------------------------o-------------
------------------------------------------------------------------------------------------------------------------------X-------------------------------------------------------------------------------
--------------------------B---------------------------------------------------------------------------------------------------------------------------------------------B-------------------------------
---------------------------------------------------------------------------------------------------------------------------?-----------o----------------------------------------------------------------
---------------------------------------------------?------------------------------------------------------------?-????????---------------------------------------------------------------?---------X----
-------------------------------------------X------------------------------------------------------------------?-------------------------------------------------------------------???????---------XX----
-------------------------------------------------------------------------------------XXXX----?-------------------------------------------------------------------------------------B-------------XXX----
------------------------------------X---------------------------------------------------------X---------------------o------?-----------------------------?--------------------------------------XXXX---v
---------------------------------------------------------------------------------------------XXB---------------?-------------------------------------------------------------------------------XXXXX---f
--------------------------------------------------------------------------------------------XXX?X--------BBB----------------------------------------------------------------------------------XXXXXX---f
-------------------------------------------------------------------------------------------XXXX-XX------------------------------------------X------------------------------------------------XXXXXXX---f
-------------------XXXX----XXXo-----------------------------------------------------------XXXXXXXXXX---------------?-----------------------XX---------------o-T-----------------------------XXXXXXXX???f
--------------------------------------------B--------------------------------------------XXXXXX-XXXX-----B------------------?-------------XXX-----------------|----------------------------XXXXXXXXX---f
----------------------------------------------------------------------------------------XXXXXXX-XXXXX-T----------------------------------XXXX-----------------|------------???????--------XXXXXXXXXX-T-f
m--------------------------------------E---E----?-------E-----------------------E------XXXXXXXX-XXXXXX|--------------------???????------XXXXX---EE---Eo--B----|-----EE-----------E-----EEXXXXXXXXXXX-|-X
XXXXXXXXXXXXXXXXXXXXXXXXXXXXXXXXXXXXXXXXXXXXXXXXX--XXXXXXXXXXXXX------XXXXXXXXXXXXXXXXXXXXXXXXXXXXXXXX|XXXXXXXXXXXXXXXX------XXXXXXXXXXXXXXXXXXXXXXXXXXXXXXXXX|------XXXXXXXXXXXXXXXXXXXXXXXXXXXXXXXX|XX
