--------------------------------------------------------------------------------------------------------------------------------------------------------------------------------------------------------
---Mo-------EX---o-E--X-o-----E----B------E-Bo--M?M--?Bo---o-------o??-B--E-M--M-X--E-M---M-----B----M-M-EEM---oBo-M----?--X--EX-?E--o-oE-BoB--E-E-B-X--?--B---?-o-?E-M--?-X??--M-M-XBX-oE-B-B--XM---?B-
----o-X---BM------?---o---EM-?E--o-Eo-E-E-Xo-X--?B---?-X----??--E?M-M--?--XM--?X-oBMEXB--?---o-o-o--?---B?M----E------X-?---oXB-E-----B-Eo-?------o--X-X--o--?-B---?--E----B|-XE--XXBX-XX--?-?M---M-EoE-
--o------?o--E----?-EX-----MM?-E------B------E-oE-----E------X--E---XXB-X-E--B-E-Xo----------M------X---oX------?EMB?-B---B-----?--EX-EXM-X??B---BM-oM?-?-E--M--M--E?--M-B--ooB-?-XXX-o--M?--BM?o?------
------?-X-------------o-EB-------o-?-B-EoXM--BB---XX-M-E-B--M-M-------EE?--B--X--E----XB-E-MB---E--M-----M--o--E------E-?X----?-------B?-XX?--BB---BX--M--o--oXMB-----?----?--?--M------MBo-X---X---M-M-
-E-EoB---o-----------o---------EX--X?-X--M---B-M---E---?-B--o-----o----??-BB-----X--E---Bo-X-?--B---M-B?-MBE-----?-???--E----------X------EXB-EoM---B---M-MB-o-o-oX--B--???---XB-----E-X---X-E---X--o-B-
----E----XMBE---E--oE-----?-?-XBo-o-B-EE--BBM----M----o-E--Xo-M--XE--?-B-Bo----X-B-B-E--?-M---o-?--XE---B--X?--B---------o--B---?-XoE-o-------E-EBB--oB-------?XX------EX-----M?-?-EB-?----------?------
------?o-X-?X----X-o----M-Mo-X-X--oBE-E--o---XX-Eo--X-----XMTX---M-oB---M---E--BB--B------E-----E-?--Bo-?o--X-M--B---BB-B-X-X-E----B----oB-E-----MX-E------o-BX-o--BoBEE--X----oB?E--M------BEX?--?B?-Bv
--?oX?B----?---o-EM----?--X------MM-E-?X--Xo-M---X--------?---o-M--EE----o-X-----B-o-o-B------o--B-XX-?-E-X-B-------X--M-?B------E--M---B-B--oE-oB---M-?----------X----Bo--X??-?------X-------M---XT---f
---oo-M-oE-|-o-----X--EB--X-XB--o---?-?MM---?-MX---?--------E---o-B----EX-B?-E-E---?---E-E-E-X?B----M-EBo---MXXo-----ME-X-T-?-X----?o--BB------ME-?-XE-M--E-B---XEB-----B---XBo-----Bo-?XE-Bo--MX----BMf
-BX-?--MEE---BE-ooX----B--?---BEX-B---------o-----B-BXB?XBBE--Eo-----MB---?-----o---E-----M--EX--XX----BE--X?--M---EoM??------X-X-o----E----?--X-o---EB--o-----M--o---?-oEX---o-B--B?--X-?X-X---M-o-E--f
--o--M-M-?---o----o---E--oM-?-oE-o--E-?-?-E----EB-E-o?--?-o-X--M??B-?----?---BoB-E-?X----E----o----M-----E----E-E?E-o--o---X?--?B----o--B?--M---X--Xo-----E-XB--M-?---o---EE-E--M??M-B-?-ooEX-EBo--?M--f
-X------E-M-----XB----BB---E----oE--o-Bo-----?M-----?BE-X-MBE----?-B----BE?----E--oX--?---o-XB--M--X--??-------E---B--B--------MoB---MM-M---B-XM-B----X--M-E--?M--?--ME-X--Xo--X--?----o----B-E--------f
-o?--M---?-o-M--M--Eo-B-oX-E-X-----X--Eo??---Xo--B-EEB-oo?MM-X------B---X?-M----E-----X--XM-X--XBBB-E?X-------B-?X---BB-----?MM--?--oMB--?-X----X-EE-----XE---Xo??XBE-M---o-M-XoMEM?----X-E-o-----oXE--f
m------B-o---------M-MM---M--BE--?E--B--o-BE-Mo-E-oXEB--?EMo---B-MX-o-X--E??-o--X-X----------XX--E-o?----X??B?---X--XE-ME---Bo--EX------X--XX?-----B-EX---B-B-oB---M??o---B-----?-X---?o---M?XBXM?-X-E-X
XXXXXXXXXXXXXXXXXXXXXXXXXXXXXXXXXXXXXXXXXXXXXXXXXXXXXXXXXXXXXXXXXXXXXXXXXXXXXXXXXXXXXXXXXXXXXXXXXXXXXXXXXXXXXXXXXXXXXXXXXXXXXXXXXXXXXXXXXXXXXXXXXXXXXXXXXXXXXXXXXXXXXXXXXXXXXXXXXXXXXXXXXXXXXXXXXXXXXXXX
