--------------------------------------------------------------------------------------------------------------------------------------------------------------------------------------------------------
--------------------------------------------------------------------------------------------------------------------------------------------------------------------------------------------------------
--------------------------------------------------------------------------------------------------------------------------------------------------------------------------------------------------------
-------------------------------------------------------------------------------------------------------------------------------------------------------------------------------?------------------------
--------------------------------------------------------------------------------------------------------------------------------------------------------------------------------------------------------
-------------------------------------------------------------------------------------------------------------------------------------------------------------------------------------------------XX-----
-----BBBBB--------------------------------------------------------------------------------------------------------------------------------------------------------------------------------------XX------
---??????--------------------------------------------------------------------------------------------------------------------------------------------------------------------------------------XXX-----v
----------------------------------------------------------------------------------------------------------------------------------------------------------------------------------------------XXXX-----f
---------------------------------------------------------------------------------------------------------------------------------------------------------------------------------------------XXXXX-----f
--------------------------------------------------------------------------------------------------------------------------------------------------------------------------------------------XXXXXX-----f
-------------------------------------------------------------------------------------------------------------------------------------------------------------------------------------------XXXXXXX-----f
------------------------------------------------------------------------------------------------------------------------------------------------------------------------------------------XXXXXXXX-----f
-----------------------------------------------------------------------------------------------------------------------------------------------------------------------------------------XXXXXXXXX-----f
m-------------------------------------------------------------------------------------------------------------------------------------------------------------------------------E-------XXXXXXXXXX-----X
XXX---XXXXXXXXXXXXXXXXXXXXXXXXXXXXXXXXXXXXXXXXXXXXXXXXXXXXXXXXXXXXXXXXXXXXXXXXXXXXXXXXXXXXXXXXXXXXXXXXXXXXXXXXXXXXXXXXXXXXXXXXXXXXXXXXXXXXXXXXXXXXXXXXXXXXXXXXXXXXXXXXXXXXXXXXXXXXXXXXXXXXXXXXXXXXXX---X
