--------------------------------------------------------------------------------------------------------------------------------------------------------------------------------------------------------
--?------o----E-E-ME------B--Xo--?--o--o----X----oB-EoBMXE--M-B--X------ME---E--MB--X-o---M---X--B-----M--oo----X-----E---BE?-X---------M-------------M-o-E?----X--o--X-BM----B---X??-?MX-?XB--BX-X-?o--
------B-E---o----E---XBo-------o--B?---oEEo--------E-Boo--B---?-??-E---B---B?---?--------M-X--XXo---X--------oM-?XB---ME-MoX---E------o------?MB-X-o------X-EB--X-B-?BX-X-B-B-X------X----X-??o-E-o--??-
-EM----o--?-M-Bo--M-oo-B----EE-?-?---MEM-----EoBo-XBEB-Bo-M-B---?---X-E?Xo-B--MB-E---?B--EE----oEM--X-o-oE-M?---------B-oM-----B-oX--oE-----B------MM-EMB--E---B-----MM------B-M-Bo--Mo?-?-M--XB--o?E-?-
----E--M---o-E-o-o--X--?--E------?--o-Xo-----X-o?o----X?oE-E---------EXE--B-?-M-----o-----M--XX-M-o-----?---EoMoB-?MXX----BE---o?--Bo-Eo--B?B--X-X-B---M?---ME-XBBo?---?oE--?--XBE-------B-XE----Bo-BE?-
-X-MoXM-oE---BM-B-E--o-----B?--------?-BX?--?-M-?--oo--?-oE?X-E-XM-E---??--------M?----ooo-----?----Mo---M---B-----?E---MBX---ME-B-X-?-M-BE------M--?M-B-XX-|---?Eo--B--M--E|X--E---Bo---XB---M----X----
--B-E---o----EMM--E---?-EEM-?B-EM----M----B--ME--?M-----M---Moo?-XX-E?-?--M-oBE-?E-----E---MoX-B--oE--X----X-EE-?ME----X----X-------o------o-X--X---?------EM-X----E--X--B-o-E------X-??-X----?--X-o?-M-
--ME-E-XMX-B----B--B------MMoB--?B-B--E-E-----?MXX?--BE----X-X|-E?--oE-o--o----B-BX---X------E-EB--T-E--------XEE?EMM-X-------o--X-Bo--M---?o--o----T------X----MM---oEB-B-B--X--o--X?-o-------o-?---E-v
-----B-M--X?M-?-?M?---E-Bo---E--B??MBo-MM--B----o-?-BX-M-B-----EM-E-MB-E--EXEE--B-oXBo---EB--XX---Mo--E-B-----o-X?oE-oEo--X---?o-M?---X?M----?-o--M--XE-oEEBB-?----?-B?--o-?----BB-M---M-X?----o-------f
--o--X-----o--XE-EE-BEX--MB-B---M-----EoM?B---MEM--B----o--?--o?----M-E-?--E-BXE---B--E??XM-M---EB-MBX-oBo----X?--?--B?-E--oB?-M-X-XXX---X-X-----XE-B-?--o--E-EM--B------Eo----B--X-B-o?------B-X---B--f
-?E-Mo?B------E----B-?X?X-??----o-?-oM-X----X-X---XXXo-------BBB---EEX--?X--X--EE-?----X--oEB------o?-XX----?--?-----E-EXXMX--E?M--o-?------X---o----o-----------B-oo--oX-X------X--Xo----X--?E--?----?f
--?-XMX-E-----oX---M-oo?-?------?o?X-E-MB---oo----Moo?---?-B-B---?--E--------B--o--E?-?------oM-EXE-M--BMX-E-XB-------XMo-E---E-Moo---E-E?----o--X--M---?--?--?----B-M--oM---o?M-E-----E---M-----M-EBXof
--o?X------?-X??M--B-?-MEXBo---Xo-M-----------?-XE-Xo-MB--BM?-o-oo-------o---BB---MMoMoEB-B-Eo--B--M-M?E--------X-XMo--o-o--?-----EEE---MM----BoEB-?-?o-E----M-EE---o-ME---o---B----M---M-XX----?-XX--Mf
----M----XX-XME-M?--EoM----Xo---XMX-----B?-XX-----M?-B----o---?-----M-o-M-X--o--B--M--B------BX--B---EX-?M------BX-o--------?Mo--?-M--------?--------E---XM-B?--MBE--o-----E-XB---XX-EX-Mo-E------B-XM-f
m-----o---E--M-----XMM-XE------?-?----E----E--M------?-E-?---?----?--M--M--B------B-EE-B---------B---o-----?XE----B-B--o--?----B-----B--?M-XM--M-EM-----o-X-?--EXB-?-?----MB-o-M-o----M------BM-----XB-X
XXXXXXXXXXXXXXXXXXXXXXXXXXXXXXXXXXXXXXXXXXXXXXXXXXXXXXXXXXXXXXXXXXXXXXXXXXXXXXXXXXXXXXXXXXXXXXXXXXXXXXXXXXXXXXXXXXXXXXXXXXXXXXXXXXXXXXXXXXXXXXXXXXXXXXXXXXXXXXXXXXXXXXXXXXXXXXXXXXXXXXXXXXXXXXXXXXXXXXXX
