--------------------------------------------------------------------------------------------------------------------------------------------------------------------------------------------------------
-M?---o--M-oM-oM-?--o-------------M--XE------------E-EB----X-X--------o-M---o----X---?M--MMo--o-EEB-M--M----B--B--X-Eo-----E--?-o--X?--MEB-XM-B------M?-----BB-??X-E?B-BB-oXX-BX-MoM---o-M-----B---B-E?-
---E-M--X--Eo--o--EM-----E---X------X-----?M--E--MoM-BB----o---o-EXE----B--M?X--E--?--?-?oX---EX--E-X---------o--E---X--XoBEXE---o--B--B-X---------o-M-M-E--XE?X-MB-M-B?B----ooo---------Mo----|B-?--?--
--?M----Bo-E--X-MM----B?----------E--B----X---E-E-------------------XoX--B??X-ME----o--MX-----M--B---MB-E---E?o?B?X---oXo-?-M--------o-M--B?-EE-M--B--EM-----E-----M-MMM-----XX---MX--?B-X-X--E-X-X-o?E-
-M----o-B-----X---M--B--E--B---X-------M---X------oEMM?-?--BM--X-Bo--X----BBEX-----?-------M--------XE---M--o-o?XoBM?--?M---XooX--------X---?----?--B--M----X---B--?BM--?-B-------X--oo?E---X-o-o-------
--o---M--B--M?-?-X---?-MX---M-Bo-o-B--B-M-M-X-M--o---X-Eo--?ME-?-BX---X-o-----X--X----B-oo-?--E-Xo-----oM---B-E---Bo?M---o?o--MEo?-----o-B--E---M-?M?E--o-XMTM-B--X-o------X---o--EX---B--o--?oXB-----?-
---EBMB-?-----M??--B-o-o-B-oM-------XMME-XEo--oE---Eo?--o-X---?--X--M----X?M--?X-ME-M--o-E---BoE-B-E--E?B-EX----?o?-B?B------?----------BX-------B-X?--BXX-M?B-E--M--------o-?X?XX-MX-----?X-M----??--E-
--M-M-o-?---B-M-M--------?--?X-XB-X-?----XX---oXM-E?------M------ME?-E----EM----B-E-o-M-o?------B---E--M-M--M-X--?XE-B---B---BB---X--o-M-E----X--XM---E---X----ME-B--oBB----E--M-MXMBMM-Bo?--EB-?---XoEv
-------M------?-?E-oB---MM--?--M-B---ooX?--?---EB-X-?o---E-?--o-?-----MB-oBE------EE-o----oM--oXE--X-X--o---BE-------o---?--o-o---?M--X--BB--oEM-?-----?--?---E-ooE---M--?M----------Eo-E----X-o--X-X-Bf
--?B-----MX-X-----E------E-M--o----o-??E---TMXEX---B?-MM?------o------??--X--B---MMoo-E?--?-E?-XE-M-BE-?-E---B-?--X-?B--XM---o-X-X--B-M-E-XB--M---E-E-?X--B---oMBE------B---X-B---oB-?-?--X-X----X----Tf
-oXoXM--ME-o-?---BB--?oE---BE--E--M-B-X---M?-M-X-X---X-E--o--?-BE----o--EE--------o----?--?-----BE---?X---?E?E---E-o-E-MXEEX-EoE--X---------XX----oX-o-------E-----------EXM----EBE--?----XE-X-EX-E----f
-?---------------BMEo---X-?X--B----Xo---X-o--??--MBMX-o--?oB------X-B??----MX-Moo--??-XE--------M-EXM--XMXB---X----?---M-X-X--E--M-o--XX-?--M----X----M----------M-o-Bo--M---------oE--M--------BB-BX--f
-?--XX---------?-BEXEo--E?B--?--------oE--MXB---M---o--B-o---BM-o?--o-X-ooo----E----B--o--X----B|?-M--E?o---B----E--------E-?B---X-?-M-E----o--------Mo------E?-E-----EoX---M-oEoM--?--M---?X------?--Mf
-----E---?o-M-?-Xo-oooM-MB-o---E-X--M---B-------?-E--?oX-----E-X---MoE---X?B?MM--M-?--o------BE?--?-BE-----X--BM--B----M---E-ooB--M?B-XoE--------B---?----?-------M-----oEM----o--BX-B--E---E-----B----f
mE---XM-M---------B---Bo-oM-?M-?-M-----E---M--E---B---|o-MoM?M--??E---?-----|E--E-XBXo--X----M?E-B-EX----X?--EB------M-o---E-o-o-----EE-----------BXB-?E-E--B----?---o----X------EM----B---X--o--oM?BX-X
XXXXXXXXXXXXXXXXXXXXXXXXXXXXXXXXXXXXXXXXXXXXXXXXXXXXXXXXXXXXXXXXXXXXXXXXXXXXXXXXXXXXXXXXXXXXXXXXXXXXXXXXXXXXXXXXXXXXXXXXXXXXXXXXXXXXXXXXXXXXXXXXXXXXXXXXXXXXXXXXXXXXXXXXXXXXXXXXXXXXXXXXXXXXXXXXXXXXXXXX
