-?-------------------------------------------------------M-------XXXX------------------------------------------------o---------------------------XXXXXXXX----------?----------------M-------------------
---------------------------------------------??????--B-------------------------------------------BBBBB-----------------?----------------------------------------------------------------------------???-
----------B-----------------------------------------------------------------------------------------------------------------------??????----------------------------------------------------------------
------------------------------------------------------------------------M----------------?????--------------?-----------------------------------B----------------M----------------------------------???-
------------o--------X------------------------M------------------------------------------------B--------------------------------------------------------------------------------------------------------
--------------------XX-------------------------------------------------------M----------o--------?--------------------BBBBBBBB------------------------------B-------------------------------------------
-------------------XXX----------BB-----------------------------------------------o-------------------------------------BBBBBBB-----------------B--------------o-------------------------------X---------
------X----XBB----XXXX--------------------------------------------------------XXXo---B--------------------------------------------------------------------?--------------------------------------------v
-----------------XXXXX-----------------------o----------------------------------M-o----------X--------------------------o------------------------------------------------------------------------------f
-------------B--XXXXXX--------------------------------------------------M--------------------------X--------?-----------------------------------------------------------M------------------------------f
----------B----XXXXXXX----------------------------------------o----------------------------------oXX--o-------------------M-------?--------------?-------------------------------XB-----B--------------f
--------------XXXXXXXX-------------------------------------------T-------------------------------XXX--T-------------------------------X--B--?-----------------------------X----------------------------f
-----?o---???XXXXXXXXX-------------------------------------------|------------------?-------?---XXXX--|----???????????????-B--------------------????????-----------------------------------------------f
------------XXXXXXXXXX-------------------------------------------|--------------X--------------XXXXX--|----------------------------X-------------------------------------------------------------------f
m----?E--?XXXXXXXXXXXX-X-------------------E-----------------?---|---------E-o-----E----------XXXXXX--|-E------E--????????--------XXX-------E---E----------Eo-------E----------XX----------------E--o--X
XXXXXXXXXXXXXXXXXXXXXXXXXXX----XXXXXXBXXXXXXXXXXX----XX----XXXXXX|XXXXXX----XXXXXXXXXXXXXXX--XXXXXXXX-|-------oBBBBBBBB-------XXXXXXX----BXXXXXXX----------------XXXXXXXXX-----------XXXBBBBXXXXXXXXXXXX
