--------------------------------------------------------------------------------------------------------------------------------------------------------------------------------------------------------
----E---B---B--oB----XE--M?----XXo--X----------o--E--?---?--MM-o-oB----M---B------?-EoB---o-E-?--XXMMXE---oM--B-----MB------?-o--M------o---MoX---X-?----o?X--E--B--------oBo---BMo-E------M--E--B---X--
--oM-o-X?X-M-Bo-M--M-oMMBB-?B---o--EMM-----oooX-----EXM?o---M-Eo-M-B-o-X--------MEM--o-E--X--B--?-??oBB-----B--------B-M---B---ooo-ME--E-o-E-----?-M?--X-E-o-E-oEoMB---MEo----E-E--M-?-oEoX----B?-M-?---
----?-Mo---E-?-?-M-E--BE-o--?---?--oo-E--M-E?-----X-EE--E-X-o--o--M-E-B-Mo----MX?---Bo-X-X-----o-o---MX---E-?----o-o-??---E-?X--M---M-E-MB----MM---E-?-o-------B-o-----X-E-B-?M?-E-MEoME---Bo------?oBX-
-X-----B-----o--X--M----E---B-E---M-?-?--o---X--EXE-oM-X-MM--MMEM-BB-EoE--oB-o---o-o--M-?-----E-o-?-E-MM-XXEX-?-M-E--X--X---M-B?E-M--X--EM---M---?M---B-B-o--M-M-----XXX---M----o-------o-M----E--?M----
--EB-?o-M-?---XEMo-?-M----X---B-B-o?M--MBE-E-------M-B--EX-EXMEMB-??-oE--?---E-E-o?----X--o-E---EE-o----E-B--o-MEXo--?B--XEEBM-?--E-MoX-EM-M?-o-B-B--E-EXE--o--X-XM-oE-o----Mo-oXE--M-?--?-BEoE-E----o--
---B-?-Bo---M-B-B--?---o?-M--XM-----BM--MM-BX-B--M----o-o----M-M---E-----X-EE--EEM?--o-X-E--B-BB----M-M-XBo----M----B--B-MB-----oX-E--E?-X---E--EE?--o-?BE---BE?----M---o-MM-?EB-XMoo--X-XMM----B-XM-M--
--oEEE--B-XE------E--MoEB-EB-E-MB-E-XMo-E--B---XX-X-M-M-M---XX?EoM----o-E-M?M-X--o-M--E??oM-M-B?o-XX--B-------M-ME--B---?--MX-E--M-----E-M-----M-EEo--M-o-B?--?-oEXMXE--E-?o--o--??M-E---M-oXo?--o-M---v
-E-------M--oMEM----E?o--M--M--M----EXo--E---B---M----o--MEoo?--------EMo--B-?MX---------X--?-oo-M----MM------XMB-o--M--o------M-M-M-B?--o-EM--M--oEM-E--BEMo--X--M?-M------?-------o-X-?--X---EM--o--of
----E--oM--M-o--?XX---Eo-o?o-??--B---o-EB-E----X-------E--?oB--?--------------X---EM---o-M-B---X-?----E--E-MXMM-?-X-MM---MB----B----M?-B-o-M--M-oM--M?o--ME--o-B-----BXB---X-B--------B?--XMoooX?---?MXf
---X--o-MoM-M-X----?--M--MX-oM?M-o---X----E-Eo-EM-?------M---EoX-----E----?o--M---M---oM?-X--?--?-M-M-E--X--X--E-E-EMXo-E-?BM--X-M--?--------o--------XEX--M-E-?-----oEEX?B-Xo-----MXX?Mo--M----B--o---f
---X----B---M---EX-MM-MEB-X---E-M-MM-------Moo-oX-E?---------o----BB?E-?EBXM-E------M-Mo--o---EX-----M-X-MB-M-o-B--o---X-M-o------?---oM-BME-M-X------M--X-X-E-?-M-X-----?M-oX-M--o-B----o---M----?-M--f
---M---E--E---M-M--M---E--B-?--?X?--X--B--B-o------oM-XB----E------M-MEBB------M--BEBX-XE---o?M-B?---M?X---M--o---M-M-X---M--o----E----M?--o--oB-E-?---o-M-----------M-------M?-Eo-?--?EE--X-B-XB-B--BXf
-?o------X--EBEM?oo--oE?-EBM-EEMEE---ME------M-Eo-Eo---?ME-M---M--?-E-B??---?B---?-----X-------E-----?--E-o-EXMB--oEo-?MB-?---?-M-E--?----X-M-?-oE-----o-MX?MXB?B-o--M-MBB--E---X---?-B---E---?-B?--EE?f
m-E-M---X-M----?-B-M-?M---?-B--?MEEX-----E--M-B--?MoBXMo-?----o---?-----o-----?BoM-ooX-X--MX--B-B-BM-BBXB--o---MMM-EMB--M?M?--E-E--E-B---M--?M--B-E---EXE-------B-?EEX???--M-M----o---BMo-?--X-X----E-BX
XXXXXXXXXXXXXXXXXXXXXXXXXXXXXXXXXXXXXXXXXXXXXXXXXXXXXXXXXXXXXXXXXXXXXXXXXXXXXXXXXXXXXXXXXXXXXXXXXXXXXXXXXXXXXXXXXXXXXXXXXXXXXXXXXXXXXXXXXXXXXXXXXXXXXXXXXXXXXXXXXXXXXXXXXXXXXXXXXXXXXXXXXXXXXXXXXXXXXXXX
