-----------------------------------o---M-------------X-----------XXXX----o------------------------M-----------------------------------------------------------------------------------------------------
--------o---B----------------------------o----------------------------M-----------------o------o----------------------------------------------------------------------------------------------------???-
----------B----------------------------------------------------?-------------------------------------------------------------------------------------------------------------????????----------------M--
--------???----------------------------------------------B-------------------------------?????--------------------------------------------------B----------------M-----------o--------------------------
------------o--------X----------------------------------------------------------------------------------------------------------------------------------------------------------------------------------
--------------------XX---------------------------------------------------X-----------------------?------------------------------------------------------------------------------------------------------
-------------------XXX-----B--------------------------------------------XX-------------------------------------------------------o----------------------------------------------------------------------
------------------XXXX-------------------------------------------------XXX------------------------------------------------------------------------------M--------------------------BBBBBBBB------------v
-----------------XXXXX---------------o--------------------------------XXXX----------------------------------------------o------------------------------------------------------------------------------f
----------------XXXXXX-----------------------------------------------XXXXX-----------------------X-----------------------------------------------------------------------------------------------------f
---------------XXXXXXX----------------------------------------------XXXXXX----------------------XX----o--------------------------------------------------o-----------------------XX-----B--------------f
---T----------XXXXXXXX-----o-----BBBBBBBB--------------------------XXXXXXX--------------B------XXX----T------------------------------XX-----?------------BBBB-------------X----------------------------f
---|--o------XXXXXXXXX---------------------------------XXXXXX??---XXXXXXXX????----------------XXXX----|----????????-----------------XX-------------------T----------------????-------------------------f
---|--------XXXXXXXXXX---------------------------------X---------XXXXXXXXX----------------M--XXXXX----|----------------------------XXX-------------------|----------------------------o----------------f
m--|--E--?XXXXXXXXXXXX------E---------M???X---------------------XXXXXXXXXX-----------E---EX-XXXXXX----|-E--------E?????o?E--------XXXX----------E-E------|---------------------E------------E-------o--X
XXX|XXXXX-XXXXXXXXXXXXXXXXXXX--XX-----XXXXXXXXXXXXXX------MXXXXXXXXXXXXXXX--XXXX--XXXXXXXXXXXXXXXXXXXX|XXXXXXXXXXX--XXX-------XXXXXXXXXXX------XXXXX--XXX|XXXXXXXXXXXXXXXXXXXXXX--------XX-------XXXXXXX
