-------------------------??-----------------------------------------------------------------------------------------------------------------------------------------------------------------------------
----------------------------------o-------o--------------BBB-----------------------------?-----------o----------------------------------------------M--------------------------------M------------------
-------------------------------------------B-------------------------------------------------------------------------------------------???????--------------------------------o---XX-B------------------
-----------------------------------------------------------------------------------------------------------------------------------------------------------------------------------------o------------o-
-------------------------------------BBBB--------------------------------------------------------------------------------------------------------o------------------------------------------------------
------------------------------------------------------------BBBB-------------------------------------------------------------------------------------------o--------------------------------------------
------------------------------X--------BBBBB?B--------BBBBBBB------------------?----------------------------------------------------------------M-o-----------------------------M-----------------------
------------------------M--------M--M--B------------------------------o---------------------------------------------------------------------------------------------------------------------------?----v
-------------------------------------------------------------------------------------------------------------------------------------------------------?----------------B------------------------------f
-----------------------------B--------X--X---------X---------------------------------------------------------------------------------------------------------------------------------------------------f
-----------------------------------------XX-----------------------------------------------------------M-----------------?????----------------------------------------------------------B?????----------f
----------------------T------------------XXTXXX------------------------------------------------------------------------------------?--o-------------------------?-----------X--------------------------f
--T---------------M---|--------------T---XX|X---?------------XXXXX----o---------------------------------------------------------------------------------------------------BBBBBB------BB---------------f
--|-------------------|--------------|---XX|XX----------------------------------------BBBBBBBB---T------------------------B----------------------------M--X-------------?---o???????-------------------f
m-|-------------------|-----E---E-E-X|---XX|XXX--------------------------------------------------|--------------------BoEBBB----------E-------------?----XX--------o------------E-o---E----E-------E---X
XX|XXXXXXXXXXXXXXXXXXX|X-----------XX|---XX|XXXXX----XXXXXXXXXXX---XXXXXXXXXXXXXXXXXXXXXXXXXXXXXX|XXXXXX----XXXXXXXXXXXXX--XXXXXXXXXXXXXXXXXXX------XXXXXXXXXXXXXXXXXXXBXo-----------------------XXXXXXX
