-BTM-o-|EoEoTMETXEoTM-oo|TX|-ETM?B-M-oB-MoET|?Mo|MTMME|EBoXEEXT-M?oT|?|?EEoMMo?T?M-MX---|TBTBTT|-E|oM|oB?BBXooTMM?oX?M?BTMEBo|o-?TXTBX|oooEM-BTTTToTTX-EX-Eo-XTT||-MBMXMEXT-TXoTTXoE|B?TB-MoXX-o?--TBMXX
M--|----BM|--|-XET|XTM-M-|o-?--|-?XX----oX-----o-M---o?-o-B|--B--|BME--M|-X-----M------?-M-XBBB-??B-M-|--B-------B-?BXM-E--E---Eo?-M--o---M-X-E-E-M--XE---oX-B--B---X-----B-B----M------?---?-EM---?---E
T--o?-B-?---X-X?E-Mo--MB--E-o---X-o--BEBo?------X---BX--E------?oMoB-B---E---MM-ME-----M-?-----------oXX-------o-----E--B--o--------?-----MEXX---oo---oX-X-----?Xo------MME-M-Mo-E-EM-----E----?-----o--
--X-E----EX-MMXo-?BoX-X-B-X-------o--?E--X?o-X-B---E---M--B--oo--o-?--B-XB-ME--oX-EMM---Mo-oooBEX-----B?----E---Eo--BEB--o-M---EX-M?E-E---X---X-------?--??-E--?o------M-----o-------?------E-----------
?-M-B----B----M--?----B--------oEX--?-MBBo?--?EoEoBE--B----B-E--o-MB------X--EM--M----?----BoBE-E---?-M--MMMo--?---M--XB--E-B-?-?--M?E-o--?------?M?-B-----------?o------X----B-?---o---E---M--EX-?-B--X
o--?o------?X---------o-E-o-XXX-oE----?--M---EoE-B-o-M-----X--o-E-M-B----o---E----------B-?M-oXoo-----MX----------o--o-?-X?oM?---E-E-----M-----E------o-E--o-X-----------o-X-------E--B--M?----M-Bo---ET
MX-----o?X-MX--Mo-M----oB---?---o---E--B?------X--M-----EE------------BX-?-oX----M---?XBM-E-----B-EBBooo---------MM----?--X---M?--o--EB-------XM-?--?M---?-?-oE--o-E-----B------o--o?--?M-?------oo---?X
BX?-EB-o?E?EX--o----M----B--?o--------oooX-EM----------?M-X-B-??-B?-M--E-?-o?--E-------M----X-BX------MEMX---BME----E---?---B-?-MME--EB??o---BEEXo-oE---oM--X---B---?-oX----------E-----?-----M-X--M-?-v
?-----------B--E--XM--?----BXB----Bo-E-?----------?E--oM-XX---B-M-B------o?B-----MX----E------XE-----B-----X-----Xo---------B----ME--M------?----XM---E--------BE--?B-----E--o-------E----o-M--B-XX--X-X
T-E---oXX--X--E-----E----------M-E?--------X?B-MB-oE--------B-BEM----X-ME--M---o-------o-----------Mo-X----B?-BMXBX-------------E-oE---BM------??-----o?-B--------M--E---M---B---E-----M---?M-X-?o-----T
?-EX-E---o-X----?-------?-------------MX--X-oM-?B-----oX---?-------M-------o---XoB--EX-BM-B-----oB-oB-o----o?-----o-?X-E---EM--------E?--B-E-?--E---E-B--XX--E-----------------EXE--oEE---o--?--------o-
X----X--B--o---?-o-M-oXX------o-----E?-XM--oBM---?BB--M---?-Mo---o-o-X-oEooB--M--M---XB-oo---X--EM-------X-?---?o-o----------oMX-X--?-----?------E--?--MX-M---E-?M----B---?-X-B----?----X-o--X-o--E----?
EE--------M-M-B-o-EoX---oM----X-----E--X--?-------------X-B-M-o--E-M-BMX------E----E---??E--E?X-X-----BM----?-X-E---?X--M-----X--oXBB------B-----X--B--B---EX---------?M--X?X?-----E--?E--B--BBX?-------
|---?M--EXE---o-----X----M--B---?--B-?-----o---?EE?----B---M--X-X-MBB----E-B-?oX--MBM--o?---?--?-E-?---B-----?--E---X-XB--XM---?-XB-----B----EBB-B--EEEX-----------o---?-X-?---E----------B?B?B--EM--o-M
m----Mo-M---E-??-X-o?oE------B-M-X-BEM-B-?-X---E------X---XBMo-B--B--M-E-X-E-E-?o---XoE-BE-B--o?------B-?-o--B-Eo---MB-?-?------X---M-M?-MM?X-MB--M-X-BX--o-XM-M-------BBM-M---?--B-E-M-X-o?------EM---B
XXXXXXXXXXXXXXXXXXXXXXXXXXXXXXXXXXXXXXXXXXXXXXXXXXXXXXXXXXXXXXXXXXXXXXXXXXXXXXXXXXXXXXXXXXXXXXXXXXXXXXXXXXXXXXXXXXXXXXXXXXXXXXXXXXXXXXXXXXXXXXXXXXXXXXXXXXXXXXXXXXXXXXXXXXXXXXXXXXXXXXXXXXXXXXXXXXXXXXXX
