--------------------------------------------------------------------------------------------------------------------------------------------------------------------------------------------------------
----M?-oE--------?-M?-?---M?X---o--?o-X--EMM-----XoE-o--?BB-----X---E-MMBX------?-----M-oM--M-B----M---MM--BM---o-o--B-o-o--XEEB-------XMME-o--X----E---M---EE--X-M-----XMBM----oX------o--BE-EB--XM----
--E?-B-----------------?-----E--E---E-E----M-M--M-X-?---E-X-B--B-?B?-----B---M-MX--E--M----?--E--M--M---EBX---X-------?--?-E-------E------ooB--?oMo-XoE-E--EX-M-Xo----M-M---MBE--M----o----X-??-MM-XB---
-B-M-----Mo-E-X-XM-E-X---M-?-----o-oM------?-?---M-oM-B--?M----E--M-----o?X-?o-B---------?------E?--?-E----M-Xo----M-X?----------XE-E----B---EX-----X--B-X--EB-------XB--o-?E-oXE---BE-o---M-Xo--M-o----
--E-M----o----X-X--?-o-BX----B---X-M-BB---MEB-BE-E---XMB----------M--B---E?EE--|?-----X-BM---Moo---M---X?-----X?----M-MM--M-?o--B---MBXE-oEoB-----E-?-E-?X--o-M------oo-----?-M---X-X--X--?X--o?----o-B-
-M-M--o-EB---?-o---------------B-o?--o-B---M-----E?------------X-oEo--?---E---?-X-E--?-Eo-ME-E---o--?E----------X--o-B---------XBB?----T----?---MEXM----B---X-M-?o------o----?--X-----M------M----oo----
-B----BM-o--B-??----?---X-oE------M-------MX-M----M-oB--oM--o-o-BX-M-X--X---MM-------oX-|M---?-----?----E-E-----M--E--BM---B--E--M---?----M---M-B-M-oo-B--?E----?--B--oo----Mo--X-E-----?-E-X-E---X-----
---o----------XBB---o-BMM-----X---o------EE--XBX-B-XM-EB-?---oBXMM-B------o--XX-B-X--B-oB--E-oMX-?------------M-M-E?EX?--------oo--X-----B---------?M-M-E--M-----B-o-XXo----M--Eo--Eo---XEM-?XMX--?--?-v
---B--M----------?o---o-?o--o--oo-?--------B?--oB-??o--BMEB---o-M---B--EB-----------X-?M---X--Xo-X-M-o-----B------XMX---X--M--o?-o---E?B--------o-----X--------?-XMXX--oo---?----M----------MT----|----f
-----EE-----?-X--o--B-----oX--------E--EoE-X-?--?--BM------M-?E--ME--------oME---E-?-------MM--?-------?------E--E------X--M--o-o--?E?X----X--X---Mo--M--XBX--o---EB--------EE?---MB-M--XM--M-XE-EXE-BBf
-----M--o-E-X--B-B----?----BXM-?-M--?-----EM--oXX-------M?-------EM-?M-X---?-EMoE--o------?-M-?X-?---o-ME?-o-E?X-X--oE----X--------E--B----------o---o----X-B-------o-X--M-----o---B----Xo--?---oM-X---f
-----XX-----M-X----??-X-E-o-?o---B--M-------M--|-?--B-M----B-E--MM-B-B---?---E-?-?-B--?-oMB--M----oM-Xo--B-----XM--EX-X-B-MM-o-?oE---E-M---X-X-X--?-------XEX-Xo---?-X?B-B-----TB------B---?-E--M-o-B-Bf
-M-M--B??BBX--E--oo--o---B------?MB----M----Xo-o-?B--o-ME------E-MB-B-Mo--o----EMX?---XB---?--XoEX-o--M--???M-XMM-E-?-?EXX-T-o?----X--M-M--EB-----------E--BX---X---M--B-X--?M--E-oBM--?---E-E--o--o?-Bf
-MBX---------X-------o--o----B--E-XBo--o-B-M----Eo----X-oE-------oE-|-----X---B?-?-B---o-----X-BE---Eo-X-------o---X----T---Bo-o--------|-M--o?XE--?--M-E--o-MBB-?-----E--X-------o-E-X-X---?E------EBEf
m--B--B-M--------Xo---?X-?---o-BX---XEBX-T----??--?Bo-------M--?--oXE-B-----------?--?--o------oE-----MX--B--X---XX-??-MBXB----X----------------XE-----o--E--|M--o-o-XB-ME--M--o?--B--?-o-XE-E?-------oX
XXXXXXXXXXXXXXXXXXXXXXXXXXXXXXXXXXXXXXXXXXXXXXXXXXXXXXXXXXXXXXXXXXXXXXXXXXXXXXXXXXXXXXXXXXXXXXXXXXXXXXXXXXXXXXXXXXXXXXXXXXXXXXXXXXXXXXXXXXXXXXXXXXXXXXXXXXXXXXXXXXXXXXXXXXXXXXXXXXXXXXXXXXXXXXXXXXXXXXXX
