-------X-------o-----------------------M-------------X---M------oXXXX----o------------------------------------------------------------------------------------------------------------------------------
-------X----B---------------------------XX-?-?M????--X---M------------------------------------------o---------------------------------------------------------------------------------------------------
------------------------------------------------o--------------?--???????-------------------------------------------------------------------------------------------------------------------------------
------BB???BB-------BB?oB??X???M?-----------Xo-------------------------------------------?????-------------------------------------------------------------------------------BBBBB----------------------
-----------------------------------------------------------------------------------------------B--------------------------------------------------------------------------------------------------------
-----------------------------------------------------------------------------M--------------------------------------------------------------------------------------------------------------------------
-------------------oB-----X---------------------o-------------------------------------------------------------------------------------------------------------------------------------------------------
------X----X------------------------------------------------------------------XXX----------------------------------------------------------------------------------------------------------------------v
----------------------------------------o---------------------------------------M-o---------------------------------------------------------------------------------?----------------------------------f
-------------------------------------------------?---------------------------------------------------------------------------------------B-------------------------------------------------------------f
----------------------------------------------o---?B---------------------------------------------o------------------------------------------??????-----------------------------------------------------f
-----------------------------X-------------------------------------------------------------------------------------------------------------------------------------------------------------------------f
--T------------?-------------------------------T-------XXXXXXX----------------------M----------------------???????????????-----------------------------------------------------------------------------f
--|-------------------X---o--------------------|-TX----X-XX----------------------------X---------------------------------------------------------------------------------------------------------------f
mX|XEXEE--X-----------XX-----E--o-----------E--|-|--E--oXXX--?---E------E----X-----EBEBBBBB------------------------------------------------------------------------------------------------------------X
XX|XXXX----BBBXXXXXXXXXXXXX----XX-XXXXXXXoX----|-|----XXXXXXXXXXXX---XXXXXXXXXXX-XXXXXXXXXX---M---XXB--------XXXX---XXXXXXXXXXXXXXXXXXXXXXXXXXXXXXXXXXXXXXXXXXXXXXXXXXXXXXXXXXXXXXXXXXXXXXXX--XXXXXXXXXX
