--------------------------------------------------------------------------------------------------------------------------------------------------------------------------------------------------------
-o?-----?------B-B--X-------------B--Mo---------M--B---B?-----o?-XX--BEB--M-----BE-oo-----BE?-B-----------M---BX----?-X---B---oM---?--B---?-X--BE--B----E-B-M--B--X----M--Eo-----M---o--?-----o-X----E--
-oM?EBo-------M-MM?----Bo---MoM-oMoo-E-o-M-----o-B-EEEMEE---EM?--B-X-T---o-E-B-?E----B---------?--------o---X--o-----X--------B-XEB----X?------?B------?----------B----B-----Mo-o-B--E---------M--M-o-o-
-E--oMMXXB-M-B-----X-o---BE?-E-----BB----------B-oB-E--X--o-B?--B--M-----M-E--E---?o-----X--------ME---?M-o-MM?----E-------oB-BB-XE------B--X----B-o--BXEEM---o----oBo--?---------X-B----oB--X----MB--E-
---EBo-------M---M?--?-XB?--MoBo-M---?E---??-----M-BE-------E-----B--?oB-o---o--ME-M---X-o-----?--?--------BB-M-?----o------oX---?ME-----B-Mo-E------M--?E-X-B--??o-----B----EEX-MEX|XMo?E-----BEB--MX--
-M--M-?E-----M--Xo--B----MB-X-M-------??-M------E?------MX--o---XB---E-Xo---B---------BMM---?o------------X-?-------?--E-----?-oM--?-M-------?-ME---XM-?-?--X--EB-M-E---B--X-E---E---M-B----?--o-----B--
-B-------B--E---?----o--B-X-MEM---o-ME-oX?---XE?MM-----EMX-?o-------M----E-?-X----o-?--EM-o-oXM-----?-?--oM-o---M--?-BE----B-B--BB--M--E?--?-MM---MXM--?---?--B-oX--o-MM--XMBMX--B?E-o-M--BEX--M-BMM-X--
-B-B--oE-B?--M--------E--?--M--X-o--X--M----B--------X--?|-B--M----E-oo--X--?Bo-----E----??-E-X-B---------E---BEE-o--X-----X-o---X?----E--XX-----M-----?XMEE-X----X-M-----E?--EoX-X--o-M--X---ME------Ev
--E-E-----oX--o?o--oM---E----Moo--o--o-----Eo-B-X---E----------XX--E--M------?M--?---XEE---EXB--MM----XM---?-M-------------?---XoE-----X?--XX-MX---o-?----?E--Boo-B--------T----X-?MM-M-X-Eo??----M-X--f
---EE--o-----o-E--EM----?MM--ME---E----o-----M-B-M----B---M----BB--------E-E---M-o-------?--E---o--ME?------?-EMM--X----E--oBM-----B-XEX?ooBE-E-?---E------|-EB----X?BB--?---------EM---?-M----------E-f
-M------?o----o---B?-?---X--M-B-----E--M--?-MooMM--------o-MME----B--------M-M--Xo-----Bo----?o-----M-MX-----------oX---E?M---oM-EX------M-X--?--X?-XooM--X-E?-E-E----??-XM-o-oo-?M--o---B--------o--?Xf
-B-M-B-B---M--E-----?-B-o-?-o?---o-?----X--E---XBoBM--o-BB--B-oEMMX-Xo---Xo---oE------o-?--?---XE------o--BEo-B---B---M?-X-oEBMX?-E----?----oX?-o?-----BM--XM--o----E-?o---?--o-B--M?-B--------B-E-?---f
---M-MM--B--B---EE--------X?--------XXX-X-M-M--M----B---E--B-ME-----??-----------X?---E-?--BMXoM-----o-?oM---M--?-o?o--E-EX---EX---o-oB-MB--o---o-M--MXoX-o-------M--E---B------------X---BEM----??EB-?f
-----o-M--X---?-EE--MMo-oX--XB?----------o-?B-MB-E-M------B----E----BM------X-X---E-MM---E-o---E--M--o--B-XMBMBo-o?-----X---E--T-----M?-----?o--M--o-?-M-oMMMX----B--X--E---o-oBXM--oX?-B----B-----M|?Mf
moMMX-M-------X-M-M-BoB---?--E-E---BBME-----E-B----E--E-------o----?BX-----oX--------M---M---B--------?Mo?-?-X--B---M?-Eo--------X--X-o--M--E----------T---------MBX-M--BB??XX--B--B--M-X--M---X---B?-?X
XXXXXXXXXXXXXXXXXXXXXXXXXXXXXXXXXXXXXXXXXXXXXXXXXXXXXXXXXXXXXXXXXXXXXXXXXXXXXXXXXXXXXXXXXXXXXXXXXXXXXXXXXXXXXXXXXXXXXXXXXXXXXXXXXXXXXXXXXXXXXXXXXXXXXXXXXXXXXXXXXXXXXXXXXXXXXXXXXXXXXXXXXXXXXXXXXXXXXXXX
