-----------------------------------------------------------B---------------------------------------------------------------------------------------o--------B-----B--------------------------------o----
-----------------o---------------------------------------------------------------B----------------------------o------B----B-----------------------------------------------------------------------------
------------------------------------------------------------------------------------------B-------------------------------------------------B-----------------------------------------------------------
--B----------------------------------------------------o--------------------B----------------------------------------------------------------------------------------------B-o--------------------------
-----------------------------B--------------------------------------------------------------------------------------------------------B---------------------------------------------B-------------------
------------B------------------------------o-------------B--------------------B---------------------------------------------------------B------------------------------------B---------------------B----
------------MB----------------------B-----------B-----B----------------------o-----------------------------------------------------------------B----------B---------------------------------------------
--B------B------------B----B-----------------------------------B-----------------------------------------------B----------------------------B--------B----------------------B--------------------------v
--------B--B--------------------------------------------------------------------------------------------B-----------------------o------------o---------------------------------------------------------f
------------------------------------B----------o--------B--------------------------------------------------------------B----------------------------o-------------------------------B---------B--------f
-------------------------------------------------------------------------------------------------------------------------------------------------B----------B------------------B-----------------------f
-------T----T----------T---------B--------------T-----------------T----------------------------------------------?--T-----B------------------------T-----------------------T---------------------o-----f
--B----|----|----------|B-----------T-----------|-----------T-----|-------------------------B-----------------T-----|----------------------------o-|----------BT-----------|--------T----B----T--------f
-------|----|------o---|------------|-----------|-----------|-----|--------T--X--T----------------------o-----|-----|-B---------------T--T---------|--------T--|-----------|--------|---------|-X------f
m------|----|----------|-----T------|-----------|-----T-----|-----|---T-B--|-----|---E----TX----------------o-|--E--|-E-----E---------|--|---T-----|--------|--|--BT----T--|----T---|---------|---B----X
XXXXXXXXXXXXXXXXXXXXXXXXXXXXXXXXXXXXXXXXXXXXXXXXXXXXXXXXXXXXXXXXXXXXXXXXXXXXXXXXXXXXXXXXXXXXXXXXXXXXXXXXXXXXXXXXXXXXXXXXXXXXXXXXXXXXXXXXXXXXXXXXXXXXXXXXXXXXXXXXXXXXXXXXXXXXXXXXXXXXXXXXXXXXXXXXXXXXXXXX
