--------------------------------------------------------------------------------------------------------------------------------------------------------------------------------------------------------
-MM-?-XM-M-XXoo-oE-BB-----X--E--E-XMMX-?-XMB--E-?oBX-B--M-o??---M----EXEEEEX--X-B-M??-XM-?--X?Eo---BB?-----BE?--M-E-Bo--M-EoMEMMMX-----Mo-E-BM-B-----oBEB--M--BBM-MM-EBM-X-?E-----BM--MXX-E--M-BM-X-----
---?--BT-?B--?T--BX----M-ME--MB-E----XB--oE-MM-XBT--M?-o-BEXX-BB----XX-oXMX-o?---EE-EoE-M--XX?--?EXB?--M-X-B?Eoo----E---MX?Xo-?-|--oM-o|Bo-----?Xo---XB---?|Xo-E?-X-E--TX-o?----oBE-M-BE-Eo-oM-E|?---Mo-
--?o--E---M-X--oBo---M??-XEX-o-?|?-o-|X-BM?oE?-EXM-ME---oM-BMXBB-E-B-X-E-X-oB---o??-oo?B?----M--Mo?-XME--|EMMB?-BX-X--?B-?T?T---|XX---BX--o-?--T--?o------X-EXBX--T?|--B-EXTXE-XT-X?o--o?B-Mo|-oB-----|-
-?--EX-M--Mo-B---E----oooo----ETB-oM??---BM?-?-MM-o--M---EB---?|-|---M-E?--B--EM-M--X-??E--?BM??EXEXM?oXE-E-X--MM----MBMMEM--oBX-T?---oo-?BMT-BM---M?o-o--M-B-o-o----E-------oMoMoo--MEX-B-?oEo-|-MMX?T-
--X--B--o-T--E-E-EM?X-XMB-?XB--Mo--B--B?X-XTB---BM--BoEEET--o-oEBTXo-oo----TE--BEE---o--MEo|B--|T---X----EEB---B-?B-M-?B-Xo-X-BM-XMX---EE-||-B-o-----X-X-EE?E-B?T---EoB?-o-?oM-o-M|--?BT-?-|--E-?oo--?E-
-?-oB|--o-B--oB-oBMoE-X-|?MT-------M--TEXE-Eo-E-M?-??-|--T-E?MT?B-----o-BEM?---o-T-X--M-MBBBE--o-BB-|M----EEM--Bo|E-M--X?--ET-M-BEo|-MBoM-B--------?--Mo-MT-E-MM-B-oB-o?o-E-TE--X?TXX-BT---oo?M---|--XB-
-oXo-?B-o----oM---M---B--EoX--Eo--XoE-B---EET-o--?-------X--B-MoBX-X--BEXX|?X--X-M-EE--EE-BM-oB-oB-XME--ME-MBo-XB?-ME?EEMEoE|X-XBXMX?X--Mo-EBXXo-oB-??BoXMB?-?oBB?ooB-|MEEM?---?Eo---B--BX?--?-?XM?MB-|v
--TEoXXo--E--E-E?-oEBo--M?MM-M?-?---MMMXXXT--BXoX---o--BEB--XM--B--X-E?--oB----M?EMB?--XBB-?B-EBX|MoEX--EE-XB-EB?--|o---o-??M---oEMoEB?-??o-?E-|E-EB-|-Mo-?-oBB-X-?-E-oTBX-o-MME-o----M??EX-X------o--Ef
--Bo-?B-M---oo-B-?-o---???-BXMXMM---oEoo?o--M-B-TMEXMX--??-?E--X-XETMX-----Xo-X-TBEME-X-BTB?-E--?-XTEBBB----M-?EME--M---EM-?---?EXEX|o-BTM---EMBo-?o-X-X-----o---BT-----?|-?-oT-ooo--?BMXTMooM---X-?--Bf
-----T--?E--E?X?--E-o-Bo-T?-?-XET--?---EB-BBX-|o?T---X-?o|o-X-oB-EXBX-EE-EE-EM-XoT-EBo?-X----oE-?-X|?-XB-EBM-XMEE--X----?--oX--BoMoMo---TXB-E?-BX-o---M-XBXXoB---?oo--B-E-M|--M-M??EE--o|M--M-o?-----?Mf
-MBME-o-E--?M-?XX----M-?oB-XM--oM--B-?-M-E?-?---TB--X-X-BTTXo?-XBME-|M----B--|--oXo-XT---X-E?B--E--BEoXoBo?---M--?---E--TX?-T--BE?--EEBB--T-Eo-oXBEB-MoBM---X|BoM?E-XB?--?Xo-EoETX-B--E-?o--TEET--oME-Mf
--M-|E--B--o---M-BBBXB-MBoBXE-?-B-B--?--B-BoEM-M---BT--X-E-M-TB|EE-Bo-----B-BMoB--B----M-T-M-----M--oo?oBE--M--E-E-B-------o----?-M-|-?--oMB--B-o-E-MBM-XX?-Xo-o??EM-X-oXB-TE-MB--oM--E--XXX|-E--oBEo??f
-?X??---|-M--BBBBM---oEEEEM-|MMo?M--o-o--o--T?--o-BE--o-o|M|--Bo?---M---?B-B---T--?----?---oMX--?-M--oM|-?B-o-?BM-oB--?--?-XEEoEoB-B-E--oX-M--ToMMoE-X-oT-X---o--XBE----?--o--XM---M-BM-oE---E???-?---Mf
m|-E--oE----?X?oo-Xoo-MEB-M---MMXE--BBo--M?MMBX-T-X---B?-o?TM---?oEX-E?MEo?---M----B?X?TM--BE?M-X-Bo---M-E?MMo-??oM-?-E?-E--B-X-E--o-X--TBo-X--E-E--BMB|?----?-BME-X-X-BMXE-X-MM?Eo-EMM----M-M--B-BM---X
XXXXXXXXXXXXXXXXXXXXXXXXXXXXXXXXXXXXXXXXXXXXXXXXXXXXXXXXXXXXXXXXXXXXXXXXXXXXXXXXXXXXXXXXXXXXXXXXXXXXXXXXXXXXXXXXXXXXXXXXXXXXXXXXXXXXXXXXXXXXXXXXXXXXXXXXXXXXXXXXXXXXXXXXXXXXXXXXXXXXXXXXXXXXXXXXXXXXXXXX
