--------------------------------------------------------------------------------------------------------------------------------------------------------------------------------------------------------
---?------------------------------------------------------------------------------------------------------------------------------------X---------------------------------------------------------------
----------------------------------------------------------------------------B-------------------------------??XXXXXXXX--------------BBBB----------------------------------------------------------------
--------------------------------------------------------------------------------------------------------------------------------------------------------------------------------------------------------
---------------------------------------------------------------------------o---------------------B---------------o-----------------------------B--------------------------------------------------------
--------------------------------------------------------------------------------------------------M--------------------------------------------????-----------------------------------------------------
----------------------------------------------------------------------------------------------------------------------------------------------------------------------------o----------o--------o-------
---------------------------------------------------------------------------------------------------------------------------o---------------------------------------------------------------------------v
----------------------------------------------------------------------------------------------------o-------------------------------------------------------------------------------------?----------o-f
-------------------------------------------------------------------------------------------------------------------------------B---------------------X---------------------BBBBB-------------o---------f
-------------------------------------------------------------------------------------------------o--------------------------------------------------XX-----?------------XMXX---------------------------f
---------------------------------------------------------------------------------------------XX?XXXX---------------?-------------------------------XXX------------------------------X-o----------------f
-------------------------------------------------------------------------------------------------------T-------------BB-------X-----------X-------XXXX---------------BBB-----------XX-------B----------f
-------------------------------------------------------------------------------------------------------|------X---------------XX-----------------XXXXX----------------------------XXX---------TBB------f
m-------------------------------------------------------------------------E----------------------------|--E-EE-E--------E--???XXX?--------------XXXXXX--------------E---E--o-E---XXXX---B-----|--------X
XXXXXXXXXXXXXXXXXXXXXXXXXXXXXXXXXXXXXXXXXXXXXXXXXXXXXXXXXXXXXXXXXXXXXXXXXXXXXXXXXXXXXXXXXXXXXXXXXXXXXXX|XXXXXXXXXXXXXXXX------XXXXXXXX-XXXXXXXXXXXXXXX---XXXXXXXXXXX-XXXXXXXX--XXXXXX--XXXXXXX|X-------X
