--------------------------------------------BBBBBBBB-----------M------------BB--------?----------------------------o----XX--o------------------------------------BBMBB--------------------B-------------
-------------------------------------------------------------------------------------------------------------------Bo-----?-----------------------------------------------------------------------------
--------------------------------------------------------------------------------------?---------------------------------------B--------o--------------XXXX-----------------------------XXXX-------------
--------------------------------o----------------------------------X-------------------------------------------------?-------------------------oBBBB---o-------------B------------------------------o---
------------------------------------------------------------------X---------------------------------------------------o---------------------XXXXXXX------------------------------------B----------o-----
----------------------------------------------------------------------------o---------------------------------------------------M----B-------------------------------------------------?--?-------------
-----------------------------------------------------------------------------------------------------------------------oM------------BBBBBB-------------------------------------------?M????------------
----------------------------------------------------------------------BBBB---?-X---------------------------------------------oX--------------------------------------------------------o-?-------o-XXXXv
-------------------------------------------------------------------------------------------------------------o-B-B-----------?----XX-------------------?------X---------o---------------------------X--f
------------------------------------------------------------------------------------------------------B-------------------------B---------------XXX------------------------------------------------XX--f
-----------------------------------------------X-----------------------------------------------------------------BBBBBBBB----o---B--------------------o-----------------------X-------------------XXX--f
------------------------------------------o---XX-------------------------------------------T-------------------------------oT-?-X-----------T----------?-------------------M----T----------------XXXX--f
---------------------T--------?--------------XXX----------------T---------BBBBXB-o---------|-o-----------------BBBBBB----T--|-------XXXX----|----???-XX--------o----------------|---------------XXXXX--f
---------------------|--???????---------XXXXXXXX----------------|---------------?----------|-------------o-------T---????|?X|X--------------|----------------------------T------|--------------XXXXXX--f
m--------------------|----------E-----E----XXXXX----------------|------------E------------E|---------------------|EE-----|-X|XXEE-E------E--|------------E---E-----X-----|------|----------E-EXXXXXXX--X
XXXXXXXXXXXXXXXXXXXXX|X----XXXXXXXXXXXXXXXXXXXXXXXXXXXXXXXXXXXXX|XXXXXXXXXXXXX-----XXXXXXXX|XXXXXX--------X?X--BB|BX-----|-X|XXX----XXX-??--|B--M---XXX---?----XXXXX-----|XXXXXX|XXXXXXXXXXXXXXXXXXXXXXX
