-------------------------------------------------------------------B---o-----------B--------------------------------------------------B-----------------------------------------------------------------
---------------------------------B------------B--------------------B----------------B---------------------B----------B-------------------------------------------------B--------------------------------
----------------------------------------------------------------------------B--------------------------------B--------B--------------------------------B------------------------------------------------
----------------o-------------o----------------------------------------------------------------------------B-------B------------------------------------------------------------------------------------
---B------------------------------------------------------------------------o------------------------B----------o-------------------------------------B---o-----------------B---------------------------
------------B--------------------B----------------------------------------o--------o-----------------------------------------------B--------------------------------------------------------------------
--------------------------o--------------------------------------------------------------------------------------B--------------------------------------------------------------------------------------
----------------------------------B--------------------------B-----------------------------------o----------B---------------------B-------------------------------------------------------B------------v
-----------B---------------------------------------------------------------------------B------B------------------------------------------B------------------B------B----B---BB------------------------Bf
----B-B--------------------------------------B------------------------------------B-------------------------------------------------------------------------------------------------B------------------f
--------------o------------o-------------------------------------B--------------------B---------------?-----------------------------B-------M---------------------------------------------B------------f
---------------To-------T-----------T----B-----------------o-T-----B---B-----------------------------------?-------------T----T--T-------------------------TB-----T------------------------------------f
-------T-------|--------|---T-------|---------------o-T------|---------------T-------------------o-----------------------|----|--|--T------------T---------|------|-----T-----T----B---T---------------f
-------|-------|--------|---|-------|--T---M-----T----|------|----------T----|-------------X--------------T--------------|----|--|--|-----T------|---------|---o--|-----|-----|----B---|---------------f
m------|-------|--------|---|-------|-o|-----B---|----|--T---|----------|----|------------------T---------|--T-----------|----|--|--|--E--|--T---|---------|-E----|-----|-----|--------|-oT--T--------XX
XXXXXXXXXXXXXXXXXXXXXXXXXXXXXXXXXXXXXXXXXXXXXXXXXXXXXXXXXXXXXXXXXXXXXXXXXXXXXXXXXXXXXXXXXXXXXXXXXXXXXXXXXXXXXXXXXXXXXXXXXXXXXXXXXXXXXXXXXXXXXXXXXXXXXXXXXXXXXXXXXXXXXXXXXXXXXXXXXXXXXXXXXXXXXXXXXXXXXXXX
