--------------------------------------------------------------------------------------------------------------------------------------------------------------------------------------------------------
---MX----??M-X-MB---XoE--M-----XX-E---o-o------?--E---Bo--BM-M--BEB-B-------E-M-------Bo--o--M?M-----o-M-E--M-----EoMB----E--?------B--o-BM--oE--XX---MM--?E---X-E-MoEo---o-o-B--Mo-B------M-X-M--------
--M-o--EXo-M-BoBE-----------?-------M?-EXX-?-B-o--o--oo-o---M-M-E----o------M?----M-EBEEM---X?M-?M--BEBo--o---X--EB--?-oB-X---B--o-ME?BoM-M-------E---MX-----MEXEoM-ME-M--??-Eo-Moo-----Eo--MMEBE-?-X---
-X--E--oB------?--MX---M--?B?MMo---BoX-?B--Eo-------M-X--E-M?----M--o-X-M?--X-MX?---Xo---E-M--E?-----o-BE-B----o---o-M--?---M----X----o-MB--------E--E-M-o-----o--o---------M?Mo---M?-XE--------o----BX-
-B-o-o-M-M-o-o--MEo-o----B--B?----M--Mo-M----o--ooE-B-BBo-EMX--EX-o-B----ME?oo-o----M-MMo?--M-X--ME----M----E-Bo--MX------?-----EM--MX---M-M-------E-?--X?---ooMBXX-?X-MX--?----M------B-----B----?--EB-
-oXX---XX-X---BE---?M-XM-B-MBo--X?---X---BX-----oE-o-B-----E---?M-ME?M-?oo--B--o-o?o---o--EEE-MEEM-Eo-X--EXo-E-X-----?-o-M-M---?EEXE--M--M-?-------X---?-EB-E--X----M-Mo-B---E-M?--XMo----EEXM-??---o---
-M--?---?EEX--B----?M-----M--X-------M-o-?----o--Mo--o?-----E?-M-EM-----?-BEB--?-----EX---?-X-EM-----EB---M---EM-o-o--B-M-B-o---oX-B-oo------M-E-BE-o?-EX-?-MX-B------E---Mo-?--B--?o---X--E----B-o-----
---MEB--ME---B---XEo--Mo--M-X--?-M--------?---oX?-XMM-M-BM-?BM--o----ooE----X---XM----?-B---MMB-?--BB--B----B-B-X-X--M?---BME--B-M---EE-E--EX--M-?o-BM--?---EM------X-E---XoX----?-MMEB-MME-X----o-M---v
-----E--M-?E--EM--?--M?E---EM--M-E---XoE-EMo-M---M--E----oo-MEEE-E---Mo-XM--X-----X--o--M--oE---M-?---B?E---------o-?---E---MB-MBM-M---BM--BM----?--oo----E-o-X--XX?-B---B-M---?--oEMooM--oXX--X?------f
----?--?---E?---?-----M----o-oo---------X-----M--?-oM?------------ME------o--o----E---Eo-MX-----X------o---E--?-??o----M-XM--M-X---M-B-?--M---X-E-?M---Mo--BMM---E-o-------X-BE-----E--?oM-EB---?-B---Xf
--M-B-M?--M-MM---MX--oX--M---?----E----E-----X-EMX---B---M-o--oX---oBEE--o?----?-oB-MXo-o--Xo----Bo----E---oB----EXEE-M?--oBMEEX-?---E----BB-?-?----?--EB--M--BB----X-E----?X---MMB-X-EX---B---Mo----BXf
--oEM---Bo-M-B---X-M-BM---BM--o--M---XM---ME-?-B-------MooEE---B--BE----E-X-oo--------??--o?---MB--M?---M-BXo----E--?o-o--E---BoB-----BE--M--E---M-E--?EEo--X--EEMo--o--?o-BMX----Xo--M---MB---B?-B---?f
-------ooB-X--?--BMM---------X---M---?-o--MB-oo-B-?-EB-M-----o--B----MX----E?-M----------M--oBo----E-M-o---M----?o-MB---XEE----X-?---?MEo-oE--oBME---X-Xo-----------XX------E---oE--M-----o--MoE--oo-B-f
-Mo-B----B-ME-E--o---o-Eo-oX-EX-oM-ooB--B-o-?--EB-----M-?-XM-----M?M--EB-M--XM-MB---B-EX---MM----o---?BEE-oBXEM-X-----MEXE---?-?--E--------X-X-M-E-----?--XE-XB-B-o------EE?o?-----??-B--XE--?--B-?--??f
m----o-?-----?-?--?-M-MXBo------M-MX-EM---XB--Eo-Xo--B-oX?--E--B---?----M-M---?BE--Mo----o-----M--EB--------E--EMMM-E-?-X?-E?----M-EoMM?BoX-Mo--B-B--E-ME-------BoXEXMM-----?X--EX-??oBMoM---B----B?E--X
XXXXXXXXXXXXXXXXXXXXXXXXXXXXXXXXXXXXXXXXXXXXXXXXXXXXXXXXXXXXXXXXXXXXXXXXXXXXXXXXXXXXXXXXXXXXXXXXXXXXXXXXXXXXXXXXXXXXXXXXXXXXXXXXXXXXXXXXXXXXXXXXXXXXXXXXXXXXXXXXXXXXXXXXXXXXXXXXXXXXXXXXXXXXXXXXXXXXXXXX
