--------------------------------------------------------------------------------------------------------------------------------------------------------------------------------------------------------
-?--M---B-o-B---o-?---X-EM-----oX-X---o-?-----X---M-o---XE-Mo-----o-M--Mo---E-X-----EoEEXM-X--?--X-M-oE--E--?-M----o--------M-o--MX-E---M---?-----?----X----------EM-E-------M---M-EBoM--o---E?M-E-XXXM-
--o-Mo-EB-oM-BoME?----M--MX-B------B--o?X--oBX-o-BM--M-Xo-E---oXE---MM------X?---BM?-M----M-----E--o-B-E--o------M-MX-o-B-X------o-XE?BE-oMB--o----M-EMM--??-X?--o-X---M-B---BMX-----?---XM--M-X---o----
-?-B?---B----E-E-MMo---oMBE-o---?X--o-EoB---oM---B--------X----o----o----BX----X?---MM-M---M--E----M-B-B--E-MoBo-----XB---?-M---E---oo----o---M---E--?-oMo--M---MB-X---?--B----oo-BMBXXE----E---E--?--X-
-BX----MB--M-----BoB-----X------B--oo------B----Eo-XBX-BEM-MM-EoM?-o-B-E--M-o?--E--BM-ME---oB-E-EM?-M--MME----B---E--X--EM--MMB-E------MEM---E------?---o-o--??X---?-MXBXM---------E------o--M-XM-?B--M-
-o-B-?B-ME--X-ME-----XXMM--Boo--B??-MX-X--XB-EXE---ooB?-----o-EM---E-ME?o?-----E-?oo-BXoo-X-B---?--o-X--E-BM-X?o----------EE-?--E--Eo-MM-M---Xo--o-----BXME--EE--oX------------MX--XM-?--?-BE--??B--oo--
--?-M?-BEM-XB-E---B----------X?---E-?M?-E?M--E-MM----??-----E?MM-E-----Mo---o----B-----E--oo----------M---ME---M---B-----MB-X------E---EB---EEM-EB--o-EEE-o-B-E?--E--oE-o-Mo-EB---?-B-X?o--EB-E----MXM--
--MBEM--XE--E?---B-?-Mo--BMM-E--------X?-E----------M--B---?-M---M-o-oB---o?M-------E-o-B-----Bo-??E--??-?o-E-------oX--?oB----MX?-----EE--o-?-MBE--?-B---------ME-M----EX-B-----?-E--?-BE--E--o-B-MXMMv
----M-------oM??--EEoM-o-M-oX----EMX--E-------MB--XX-----MX--E---M---EE-o?---?M---------M---E?E-M-?-o-X--B-E-B-BB-o--M-BE---MM--BM-M-B-----oo------oo-------M--ooM-?-o?--E?-?oo?--X-Moo--M--M--EE-----of
----?o--?----M-----B-BM--o?BE---E-X?--o-X------XM?-E?B-----o-XE----EE-----o-MM-Eo-MM-----oE-----oB--------------?-X--o-MMM--X---X--MB-E-X-M?M-?--E--X---MX-B-M------BB?M---B------B?-X-M-MM-oMo--X-B-MXf
--E-B-?B----BMoMMM-M--M------M?-------o--?--EX--EEM------E--oBoE---X-E-----X--------MBME---M--oBB-----B--M-o---EEE---M?-E-oBB--o---XEE?M--o-M?-M------XMXBE----?-M------B---XM-----X---M-X-B----X--M--Xf
--o-M--X-o--EBE-----oMME--X--M-?--B----M-----B----E----MB-E-BoMM---MME-MEoo-?---B------BMM----?B--E-?--MoX--B-o-MEM---E---E-------o----E-BMooE-X-M---oMEE-X-XEXE-ooM-M----XEM--X--M--M-X-oMB-------E--?f
---MX--EMo-o?EM-MBM---?-----?-M-o---X--o---oo-o--o?XM--MM?--M-E----E-?E-EM-E---------EE-o---B-X?B--M-o?--?---E-XM--MB--o--E----X---E-M?M--?o-o--EE------X---EE?-?--EX----MB-?X--o?E?---BM-X----X--?---?f
-M------B---EXX--??M-----Bo-M----E-X-BE--B----?---E--?MEME-E-oMB?-?EE--?o---?ME--?-o?EE--MM---E-M-B---B-EBo-M-----oEo-MBMo--Xo----E-oX------o-?M-E---M--E-B?XE?-Bo--o--X-o--o---E?M-?-?-E--BEXE--M---E?f
m-EoME---MX-MM-?B--BBEX-----X?----M--?-----?--Bo----MB---?o-B-BM?--BX---MM----X-E----X--E?----MMo-EB--B---?oEB--?-----?-B??--M---M---B---o-----B-?B-o-MB-X-B--EE-E?-E-?B---M---o-X---BB---o--B--X---E-BX
XXXXXXXXXXXXXXXXXXXXXXXXXXXXXXXXXXXXXXXXXXXXXXXXXXXXXXXXXXXXXXXXXXXXXXXXXXXXXXXXXXXXXXXXXXXXXXXXXXXXXXXXXXXXXXXXXXXXXXXXXXXXXXXXXXXXXXXXXXXXXXXXXXXXXXXXXXXXXXXXXXXXXXXXXXXXXXXXXXXXXXXXXXXXXXXXXXXXXXXX
