-----------------------------------------------------------------------------------------------------------------------------o--------------------------------------------------------------------------
-------------------------------------------------------------------------------------------------------------------------B---???-------------XXXXX------------------------------------------------------
-----X--M--------------------------------------------------------------------------------------------------------------------------X---???????------------------------------------------o---------------
------------o-----------------------------------------------------------------------------------------------------------------------------------?-------------------------------------------------------
----------------------------------------------------------------------------------------------------------------------------X--------------------o------------------------------------------------------
--???------------------------------------------------------------------------------------------------------------------------------------------------------o--------------------------------------------
----------------------------------------------------------------------------------------------------------------------------BBBBBBBBBB----------M-o-----------------------------------------------------
----------B------------------------------------------------------------------------------------------------------------------------?-----------------------------------------------o-------------------v
-------------------------------------------------------------------------------------------------------------------------------------------?-------X--------------------B------------------------------f
-------------------------------------------------------------------------------------------------------------------------------------------?M----BXXBBBXX----------------o--------X--------------------f
------------------X------------------------------------------------------------------------------------------------------------------------------XXX---o-------------------------XX----B---------------f
-----------------XX-----------------------------------------------------------------------------------------------------------------------------XXXX----------------------------XXX-----------------???f
----------------XXX-------------------------------------------------------------------------------------------------------B--------------------XXXXX----------------------BBBBBXXXX--------------------f
---------------XXXX-------------------------------------------------------------------------------------------------------B----X--------------XXXXXX-------------------------BXXXXX--------------------f
mE----E-------XXXXX---------------------------------------------------------------------------------------------------EBEBBB---X--E----E-X-E-XXXXXXX?-------------Xo-------E-XXXXXX---E--------E-------X
XM--XXXXXXXXXXXXXXXXXXXXXXXXXXXXXXXXXXXXXXXXXXXXXXXXXXXXXXXXXXXXXXXXXXXXXXXXXXXXXXXXXXXXXXXXXXXXXXXXXXXXXXXXXXXXXXXXXXXXXXXXXXXX-------XXXXXXXXXXXXXXXXXXXXXXXXXXXX-XXXXXoXXXXXXXXX----XXXXXXXXXXXX----X
