---B------------------------B---------------------------------------------------------------------------------------------------------------------------------------------------------------------------
------------------B--------------------------------B-------------------------------------------------------------------------------------B------------------------------------------------B-------------
---------B-----------------------------------------------o---------------------------------------------B------------------------------------------------------BB-----o----B----------B----------o-------
--------------------B-------------------------o------------------------------B--------------------------------------------------------------------------------------------------------------------------
----------------------------------------B--------------------------------------------------------------------------------B--------------------o---------------------------------o-----------------------
------B----------------B-----------------------------------------------------------B--------------------------------------------------------------------------------------------------------------------
---B--------------------B------------------------------------------------------------------------------------------------------------------------------------------------------------B------------------
----------------------------------------o-----B-------------------------------------------------------------------B-----------------------------B------------------------------------------------------v
---B-------------------------------o--------------------------------------------------B-----------------------------------------------------------B---B---------B--------------------------------------f
----------------------B--------------------------o----------------------o------B-----o--------------------------------B-----------------------------------------------------------B--------------------f
--------------------------------------------E--------------------------------------------------------------------------B-------------------------------------------------------------------------------f
--------T--------T----T--------------T------T---------------B-----------------------T-------------------------------------------BT---T-----------------------B----------------------------------T------f
--------|---B----|----|---T----------|o--T--|--------------------B-----B------T--T--|--B--------------------BT-------------------|---|-------------------------T-------T-----B-----------T------|------f
--------|--------|----|---|----------|---|--|---------------M--T-----T--------|--|--|--------------------T---|-------T-----T---o-|---|---------------T---------|-------|-oT--------------|------|------f
m-------|---T----|----|---|----------|---|--|------------------|-----|--------|--|--|--o---o-------------|---|-------|--T--|-----|---|------TE-------|---------|----T--|--|--T-----------|--T---|------X
XXXXXXXXXXXXXXXXXXXXXXXXXXXXXXXXXXXXXXXXXXXXXXXXXXXXXXXXXXXXXXXXXXXXXXXXXXXXXXXXXXXXXXXXXXXXXXXXXXXXXXXXXXXXXXXXXXXXXXXXXXXXXXXXXXXXXXXXXXXXXXXXXXXXXXXXXXXXXXXXXXXXXXXXXXXXXXXXXXXXXXXXXXXXXXXXXXXXXXXX
