----------------------------??-------------------------------------------------o-----------------------------------------------------------------------------------------------------X------------------
-----------------------------------------------------------------------------------------------------------------------------------------------------------X--------------------------------------------
-----------------------?X???----------------------------------------------------------------------------------------------------------------------------------------------------------------------------
------------------------------------------------------------------------------------------------------------------------------------------------------B-------------------------------------------------
-------------------------------------------------------------------------------------------------------------------------------------------------------------------------------B------------------------
---------------???--------------------------------------------------------------------------------------------------------------------------------------------------------------------------------------
-----------o--------------------------------------------------------------------------------------------------------------------------------XX----------------------------------------------------------
--------------------------------------------------------------------------------------------------------XXXXXXXX------------------------------?--------------------------------------------------------v
-----------XXXX--o-------------------------------------------------------------------------------------------------------------------------------------------------------------------------------------f
----------------------------------------------------------------------------------------------------------------------------------X----------------------------------------------------------XXXXXX----f
-------------------------o------------X--------------------------------------------------------------------------------------------------------------------------X-------------------------------------f
-------------------------X-----------------------------------------XX-------------------M------------------------------------------------------T-------------------------------------------------------f
-----------BBBBBB----------------------------------------------------------------------------------------------------------BBBBBB-------??-----|-------------------------------------------------------f
-----------------------------------------------------------------------------------------------------------------------------------------------|----------------------------T--------------------------f
m-E--E-------------------------------------------------------------------------------------------------------------------------E---------------|----------------------------|------------E-------------X
XXXXXXXXXXX-------XXXXXXXXXXXXXXXXXXXXXXXXXXXXXXXXXXXXXXXXXXXXXXXXXXXXXXXXXXXXXXXXXXXXXXXXXXXXXXXXXXXXXXXXXXXXXX--XXXXXXXXXXXXXXXXX-------XXXXX|------XXX----XXXXXXXXXXXXXXX|XXXXXXXXXXXXXXXXXXXXXX----X
