-BTM-o-|EoEoTMETXEoTM-oo|TX|-ETM?B-M-oB-MoET|?Mo|MTMME|EBoXEEXT-M?oT|?|?EEoMMo?T?M-MX---|TBTBTT|-E|oM|oB?BBXooTMM?oX?M?BTMEBo|o-?TXTBX|oooEM-BTTTToTTX-EX-Eo-XTT||-MBMXMEXT-TXoTTXoE|B?TB-MoXX-o?--TBMXX
M---E-MM?--oT----MB?X?-|?oX?-|?-M----T--oE-o----|BE-M---?---o---?---?-----??----------o-|--------?B-?-----?-MB---M-?E---------X---M---o---o-?-o-M-XT----o-M--X--M?-----o--o--X?--T-M-|------?---E---TB-E
TM-o-E-?MB--X--X---?-M-B-?MX?-----------B?M-M-------E-E-B----?M-o--B-?----X-------M----B-?---X-?--o--EB--E-o-M-EE--M-E-------?MBMXE-?------EX---?E??-E-----------E--?E----M---BMoE-E----------E--E-oX-B-
--X-----X--?MoBB-MB-B-BEEEXBX-M-E--?XoM-B-Bo-Xo-----EoBMBEo--BB-M----?B-X--M?-----MM--?----o-------------B--------MM--B-oMo--Bo---MM---?-B----?-E------BX-o--E--o------X---------E-Moo?o----E--M-E--X-B-
??---?B-o--EE--o-B--EXM-MX--XE---X-XBoB-oB-X--oo?--o-o--E-o---E--o-o----?-M----------?-X--B----X---B-X--B--o---B-----MB--X-X---X--EB----E--o-Mo--?------oM----oM-?--?XM-M-------X-----o-EM----------o--X
o-B-oX----EXX-X---?---M?---E--M-----?-oE-B----Xo-----X-X-----BM------EoX-----E-X-?--MoE----M-BXBB??-o--------E------------M--M--EEM---MXX-XEE---o-XE--M-M--B--oB--BM?---X----?--oM---------X---E------?T
MXB--?-E-??o-B-E----?B--oB----XB----?B-----?EM-?E----?---E---E-X--o----X--EE?BB--B?-----X--E----EE----X---M-E----MEX--o-M---------?-M---X?X------Mo-o?-----?--?---X--X-------M---------o-M--E-Mo--o--M-X
B---------?---oX--Xo??X--------MB---?--BB--oM--------?E-----oB??E---M--X-o----E-?--M----o----X-Xo-------?--oo---B-o--MB-XE--E---?--?-B-----oM---X-----oE-o-----------------MMM--------BMM-M------M-----v
?-EM?---B--??----E--M-M--M-MEB-M--------?----o-----B---?B--M---E-------M?o--BM-B---E-------M?-Eo-X---B-M----MX-----X-M-o-M--B--??---?B-X?M------B---?--oXo--XMMB---B--E------B------------------o-EB-?-X
TM---B-?--X-?-X-----------o-M----MX--?-M---?M-M--B-?------?-------------EM-?---B---o--M-------o---E?---EE-B-MB--B----?--E--X---EM---X-------E---M-----o-X-?---?-------------E--XM-ME------B--o------M--T
?-?----BM-B-o------B----------?----------B-----EMX---E-MX-M--?BBB--M-EB---oB--E-o-M-MoEE------E--X-----?B---?----X--M--?-M------oM--------------------X------E-----X------?-----XB---M--?---E--?-?----X-
XBE--E--ME-M-oBE---EE---M-EE-X-----X-B---X-B-E--E---X-MM-B----MEB-o----o-----?B--------XB-EB-o---o--EXoEo---B----MM?--EX?oo--B--?-??---------M---M-M---M--E-Xo--?-o--M---B--?--XE-X?---E?--XE-B------?o?
E--E--?--B?M----MM-oB----M-----M-oMB---oXXEXE--M?--o----E---M----?----?--M-?--E-----?--B-M--EBX---B-X----o----------E-E?X-X-M---M-B-----B--?-----XoB--M-------B---M-BXBME----o-MB--E-?------??o?-X------
|--------E-X-B-M----B-ME---B-M--?-?--M----X--oBEEM--?-B-XB-ME---M-M-EX---M---BB--E-?M--XEE--o---E----B---B-B--?---XM--X---------oXB-o------E-E---B??---E---M--B------?E------B--o-----M---oBBB--X?M-XM-M
m-oM-MM----X------?EX----B?--Xoo-X-EBE-B??-------?MBM-----o?-o----M--E--?--MXE------X--B---?-o---------oMB-?--B--?-X--?-------------B-M?--E------E---?E---B-M-?M---?-B?BM-----o----M---MX?-M-X?B---o---B
XXXXXXXXXXXXXXXXXXXXXXXXXXXXXXXXXXXXXXXXXXXXXXXXXXXXXXXXXXXXXXXXXXXXXXXXXXXXXXXXXXXXXXXXXXXXXXXXXXXXXXXXXXXXXXXXXXXXXXXXXXXXXXXXXXXXXXXXXXXXXXXXXXXXXXXXXXXXXXXXXXXXXXXXXXXXXXXXXXXXXXXXXXXXXXXXXXXXXXXX
