------------BBBBBBBB--------------------------------------------------------M---------------------------------------------------------------------------------------------------------------------------
----------------------------------------------------------------------------------------------?------XXXXXXXX-------------------------------------------------------------------------------------------
--------------------------------------------------------------------------------------------------------------------------------------------------------------------------------------------------------
-----------------------------------------M--------------------------------------o-----------------------------------------------------------------------------------------------------------------------
-----------------------------------------------------------------------o--------o-----------------------------------------------------------------------------------------------------------------------
--------------------------------M-----------------------------------------o-o----o------?---------------------------------------------------------------------------------------------------------------
--------------------------------------------------------------------------------------------------------------------------------------------------------------------------------------------------------
-----------------------------------------------------------------------------------------B------o---------o--------------------------------------------------------------------------------------------v
-------------------------------------------------------------------------------------------------------------------------------------------------------------------------------------------------------f
-----------------------------------------------------------------B-----------------------------------X-------------------------------------------------------------------------------------------------f
-----------------------------------------------------------------------------------------------------XX----------------------------------------------------------------------------------------X-------f
--------------------------------------------------------------------------o------------T-------------XXX-----------------------------------------------------------------------------------------------f
---------------------------------------------------------------------------------------|-------------XXXX----------------------------------------------------------------------------------------------f
----------------------------------------------------------------------T----------------|-------------XXXXX--------------o------------------------------------------------------------------------------f
m---E------------------------------------------E----------E----E--E---|---B---E-E-E----|--E??-E------XXXXXX--E-----------------------------------------------------------------------------------------X
XXXXXXXXXXXXXXXXXXXXXXXXXXXXXXXXXXXXXXXXXXXXXXXXXXXXXXXXXXXXXXXX------|-------XXXXXXXXX|X-------XXXXXXXXXXXXX------XXXXXXXXXXXXXXXXXXXXXXXXXXXXXXXXXXXXXXXXXXXXXXXXXXXXXXXXXXXXXXXXXXXXXXXXXXXXXXXXXXXXX
