--------------------------------------------------------------------------------------------------------------------------------------------------------------------------------------------------------
-oX-X---B------oBXM-----XM-----XX---X---oE----BE---o--B-MEo-MX--BE----------E?X-----?oE------BB-?--Boo-MBo--M---E-EE?o------------o-M-E--B--M?-?Eo-----XBB-XB-E--oEBoB----E-BMMBMM-EE-X----MMM---EEX-X--
--MEM--oX--M-oo-----o-----XMB-------E---o--?B--o?o--?ME-oM--M-X-E---MM--M-E-M-?--B-BMM-MM-o---o-?---B----EM--o-o---oM?BM-----o-o-?--E--EMo---E-----oB-BM---X-EX--?M-Mo-MEM?--?-E----------X----B----o-B-
----E-?--------?--ME---X--------?X-B-XE?-X-Eo---E---?XE--E---?X--BM?--o---X-XMMM--?-M--oM-M----?-----BX-E-B-M-------o-?--B?----o----XoE-XB----M--E---?-----------o-B---------X-E--?M-X-E--E---o-----oBX-
--M?-B-B?-------M-o-E----X--B?-----oXBM-E-----?-o-?----E--X-?M-XM--o---Mo-o?o?-M-E--?-MBE--?M-X-E-----XM-M?EX-?-E-------o?--B----E-o?-?-E---o--M-----X----o--BMMM-X-X-BB------X--?-X--E--M-------E-BXMB-
--EX----oM-------o---B-MMBXM--B-X??-M--X---?---E-BX?BM--B?---?ooE-M--Mo?---X--E?----XEo-M-?XEo-X-M-E--o--EXEBE-o----?B-ooM-M-X--E----oBME--B------B-o--?oE----E--X-E?EM---M--M-M?---M-E---EM?---?-X-o---
----M---?--XM------?-?-------??-----B----M---ooM----MoB--B--XE---E----oM?XMB---M-B------oM----X-----M---B-M----M-oM?--X?---Eo-o----?--o-----XEM-M--X-?--E-?-M--?---?--X-E-M--EMB-M--o-M--XM-E---o---M---
-oMMMB--Mo--MoooBX----MoB-o--------------E---o-?-MXE----oM-Xo----X-X--M?-o-?M--oX---E-o---M-MMM?-??oE-----oXB---MEX-B--o--M-B-EE--?-X?-X---o-BM-B-o--MME-MB?--M-o-M-----E-X---BX-?-B-E--Eo--X--o-o-E-EMv
--oM--E--MXE--?---E-X-Mo--MoME-MBX--Eoo-M-E-M--E--X-M-o-M-MXX-EE----M-oo-ME-X-----X--X--B---o---M--oo-BM----------o--B------M--M-Mo--B---?-BoX-MM?--Bo-B----o-X--M---X--ME--?--M-MoMMoB----X-BE----?-MXf
-E-----?--?M----------M----?E----o----M--------?MM-E?-o---X-BB-?-E---M---o--MME-?-----E--MM--X-Mo-----Mo---M--XE?-o--M-MM-B----BX-E-MBXEM--BMX---E?-XX-MX-E--M--M--?-----B----XE--B??---MBB----------E?f
----o-oB-o----XXM-?-o-X--M--MM?--o----------Eo-EMEE--B--B--B-EoE----XE---M?E--M-oM?-BX-M-----oo-B---o-------X--Eo-----o?-Bo----XM--XEE-M--o--o--?E------BBo----B------X-Bo-----oXMB---EMo--B----B-----Xf
---MX---Bo-XB?-----?--M--?BM-M-?-------E---M--B---E-B----o-EB-MMX---M-------?oM-X----?MXM-o?--BMB-------------o------o-----o-?-o--X--E--M-M--E---MoX---XMoB--E-XEMBM-----?MMX--M-oX-B--o---B----?------f
----X-----o-M-?-MX-M---?o----X-Mo?---E-o--M-o?--E-?--o----EoE--M-E---MEoXE----M--o----?o------oXM--M-o-o-?---XBE-oMMMoB---E---XX---E---Xo-??-Mo-EE---XX---X---E??--oM?----o--X--Eo-XE-?-?-o?---X--o---Xf
--------------E?---M-M-?E-?M?-?-EE---?E----E-M----E--B----BM-oM-?M-E---B--E-M--BBE--?-E---oM-X---o--o-XEo-?---M---o?E-MXMo--o--?M-E------X----?MoE--E--o-----Eo?--M---MM-E------E-oX?-B---E-??------Mo-f
m-MB-E----o-M--?X-?---?-?o?-E-B-M----XM----?-----XME??-E-?o---?--M--X--MoM----?-o-EoE----BB----M--EM---oB-M-----o-?-EBo-B?-o?-B--M-E-M--o---MM--Mo?--MoB-E-----Xo-?---?---o-?XEo---?--B-oMoM-B---X--?--X
XXXXXXXXXXXXXXXXXXXXXXXXXXXXXXXXXXXXXXXXXXXXXXXXXXXXXXXXXXXXXXXXXXXXXXXXXXXXXXXXXXXXXXXXXXXXXXXXXXXXXXXXXXXXXXXXXXXXXXXXXXXXXXXXXXXXXXXXXXXXXXXXXXXXXXXXXXXXXXXXXXXXXXXXXXXXXXXXXXXXXXXXXXXXXXXXXXXXXXXX
