----------------B--o------------------------------------------------------------oo---------------------------------B------------------------------------------------------------------------------------
---------------------------------------------------------------------------------------B------B----------------------------------------B---------------------------------o--------Bo--------------------
----------------------------------------------------------------------B-------------B---------B--------------B--B-----------------------------------------------------------------------------------B---
-----------B-------------------------------------------------------o-------------------------B---o-------------------------B--------------------------------B---o--------B------------------------------
-----B----------------------B---------------------------------------------------------------------------------------------------------------------B---------------------------------B-------------------
------------B----------------------------B--------------------------------------------------------------------------------------------------------------------------o-----------------------------------
-----------------B--------------------------B--------------------------------------------------------B------B-----------------------B-----B---------------------------B----B-----------o----------------
---------------------------------------------------------------------------------------------------------------------B------------------------------------------------B--------------------------------v
---------------B--------------------------B-----B--------------B-----------------------B---B------------------------------------------------------B----------------------------------------------B-----f
---------------------------B-----------o----------------------------------------------o--B---------------------------------------------o--------B--------------B---------------------------------------f
--------------------------------------------------------------------B------------------------------------------------B-------------------------------------------------------------------------B-------f
-----B----------------B-------T------------------T---------T------------------M---------------------------T-----BT--------------T-------T-------------------------------------------T------------------f
--------T--M---T----------BT--|-B--T--T----------|---------|------------T---------------------------------|--T---|--------------|-------|-----T----------------------------T--------|----T-------------f
--------|------|------T----|--|----|--|----------|----T----|------------|------o-------------T------------|--|---|---------T----|-------|-----|--T--T------------B---T-----|--------|----|-------------f
m-------|------|--T---|----|--|----|--|--B-------|----|-X--|--T-----T---|-----T--T------T----|--------T---|--|---|---------|--X-|---T---|-----|--|--|--------T-------|-----|---T----|----|--------o----X
XXXXXXXXXXXXXXXXXXXXXXXXXXXXXXXXXXXXXXXXXXXXXXXXXXXXXXXXXXXXXXXXXXXXXXXXXXXXXXXXXXXXXXXXXXXXXXXXXXXXXXXXXXXXXXXXXXXXXXXXXXXXXXXXXXXXXXXXXXXXXXXXXXXXXXXXXXXXXXXXXXXXXXXXXXXXXXXXXXXXXXXXXXXXXXXXXXXXXXXX
