--------------------------------------------------------------------------------------------------------------------------------------------------------------------------------------------------------
--M--B-?-M-oMXEXB--Eo-B-oM-----?--M--XE-EX---o--E-BEM-M----X---o?---B-XoM---B-EMBX---EEM-B-o--o-X-BBM--Mo-o----B--X-E-o--E-E--X---B-?B-EBB---MBX---BEBE--B----B-o-------?-oXXM-X--X----B-MB-X-E----B???-
---o--EX----BB-B---M?--X------M-----MX-X--X-o-Eo-M---BBM---o-E---B--M--X---M?M-oE-X----M?-----E---?-?---------EXo-E-XX-M-o-EXE?------EBB?--o---?-------M--o-X--XEM-oE-BX-o-----o-EB-B----B----X-X-?--?--
--MM--o---BEE-X--M----?-------E---o--M-B--X---E---------E----M?---?-Xo--MM-XXX-B-XE--MBM?---EME--M--?M--B------X?-M-E-MX?-XX---X-?--B-EM--B?-E--M--XX-X-B----B--M--M-oM??---X--E-XBX?-?--X--o-E-BBX--XE-
-M---EoB--o--E--B--EB-o?-?---o--?-MM--E---X---------X-M--------X--o-oX-----MM??-E----o-B-X----?-o----B----E-o-o-B--M---o--?XX--X------?------?---?--B---M-?E-?XoB----------M------XM-B--o---X?X-oB--BEM-
--E---?--X--M?-X-----?--X--EM--o---X--o--XB----M?-M-------XMM--?--X-o---o-EX--X??-M-----oo-X---M-o---?-X--Xo?-o---BoM----o?-o-MX----E--o----B-----?M-??-oXoM?o?B--X-X-ME--?o-o--MBXX--BoB--M-Bo--?---M--
-o--BM-X------?MBo---o-o?B--------X-X-B-M---oX----E-??--o--M---X-------E-oXB-?EM-ME-M----Bo|--oM-BM--o-BB--X----?--?-----o--o----EMB----------B-X-----XBX--M------M----B---E-?X-X---B--BM??---?-------E-
----o-----BoB-E-X---oM--E----o-XB-X-?--EX---M-o-M------M--M-E-?X-XM?B-M-o--M-o--?X--X-M-E?E----oM-Too---BM-oM----M-E---o-MM---Xo--------X--X--?--X?--oEX?-X--o--E--E--BXB-X-E--M-M-M-ME--?---EB-----X--v
--?---X-o---B---?E-o?-BXE-B-?---o---------oEE--EB-Xo?o---o----o-B--B--M----MXX-----E-o----o---E---oX--X------?-----ooo---M--o-o-E-?-----?oB---------X-B-------E-oXo---M-M--o------M--E--BX-------oX---Mf
--?BMoX----o---o--------ME--X-M-----M-E----?-XE--M-B--M-?--B---E------B---XM--EB-MM?----?---E-oEEM--BE-?--o--B-?------E-Xoo--E-XB-E--?-EE--B--M-o-E------X?o--o-MEX----E--M---X---X-E?----X--E---X-B--?f
-?Xo-|-oM?-o---------?-E---BE---------X----E---------XoEo-BB-E-BE?o--MB-oB?E--B--Xo-------?o--M-oX----XB?-?--E---E-E-E-XXEEX-EB-B-E--X---XE-X?--?oo-BX-----B-E---E---?----?M--oE-B----E-B--EB---XX---X-f
-?---XB-EE----o-o--E------?X--B-----------o-o-M--M-M---E-ooBXM--B-?X-?-o-----o--o-M?-XX------------X-M-XMX-X-BB---?-o------------M-M-?MX-----B-?---M-B---B-XB-M-E--o?-M?--Bo-----o-oo--------M-BB--o-?of
---BX-B--o---X---B-XEoBBEX---?--?----E-M?---B--BE---oM--oE--MBo-BXo-M---o?----MX-B--------X---MB-?-B--?-o-M----E-E------B-E--B---XE?-M--X?--oX-M-----MM----?---oE--?X-BEX---M-o-oM--ME-M---?B---?--?--Mf
--?--X-X--EE?-?--oEo?oM-MB-oEE-o-X-----oB----X-M--E--?-XB------X-M-Mo-oXoX?--M---M--M-o-M----XE------E----?---Mo--B----E---E-?oB--M?---X----XM----MXXM-B-XM------oMoX---oE--------BE--------E------X---f
m-----M-----B--M-----BB---Mo?E-?----BE-E-X------o-X-BE-o-MoE--X-?-X-X-------E-X-X---XMXE?-----?--E-XXM-M-X?----?-?X-Bo--E---B----------EBM-------MBXB--E------E--?-?------??--?---M-------MX---?--M?-X-X
XXXXXXXXXXXXXXXXXXXXXXXXXXXXXXXXXXXXXXXXXXXXXXXXXXXXXXXXXXXXXXXXXXXXXXXXXXXXXXXXXXXXXXXXXXXXXXXXXXXXXXXXXXXXXXXXXXXXXXXXXXXXXXXXXXXXXXXXXXXXXXXXXXXXXXXXXXXXXXXXXXXXXXXXXXXXXXXXXXXXXXXXXXXXXXXXXXXXXXXX
