------o-----B--------------------------o-------------------B-----------B-B-------------B-B--oB----------------B-------B------------B------------o---B-----Bo-------o--B---B-----B---BB--------------B---
-----------------------B-------------B--------------B-B------------------B------B--------B-------------------------B----------------B--------------------------------------o----------B--------B--------
-------------o--------------B-----B-----------------------------B----o-----------------o--------------------------B---B--B-----o----------------B------------B-B-o-------------B--B---------------------
--B---------------Bo------------o-----B--B-----B--B--------------B---o------B--------o-------B-B-----------------B--------B-B-----------o---B-----o--------B-BB----------o------------B-------B----o----
-B--o---B---------------B---B-B------------B-o----B-------------------B---------o-------o-B-B---B-------------B-------B-------o--------B--o---------------B--------B-----------o---B-----o--------------
--B-------BB-------o-----B-B---B------B--E---------------B---o--B-------------B------B------------------B----------------------o----------------------B-B----B------B----B--------B-----------B---------
-----o---------B--B----B-------------B-o-------------------------------B--o-oB-----o-----------------------------------------B-----------------------B--------BBB-o--B---o------B-B-BB----------o-------
------------------oo----------------------------o-----B-o-B---------B-B-----------------------------o----------BBB----------------B----B-----B-------o-o----o--B---------o----------B---B-B------------v
-B----------------B--------BB----------------------B---B--------B------o--------------------------B-----------BB-B---o-B----------------------o-----o-------------------B--B------------------B--------f
-------B-B---------BB-----B--B-----------------------------------------B-----------------------B-B--B-------B-------------------o-B-----------BB---------------------oo---------B---B-----B-------B----f
-E------------------------B-------------B--------B----------------B------o------------------B----------------------B--------------------------------oo------B------------B-o----------B----o-----B-----f
-B-------B-----------o---------o-----B----------------o-B---------B----------B-----B------B-----------------B---B-------------B-B------o-----------------B-------------------o---------B------TB-------f
----B------o----------o-----B----------o----T-E-o------T----o--B-----T-----T----B---------------------T-------T------------BT--B---B--B----T---o-----------------B----------------------------|--------f
------T-----X---o--BT--T---T----o---B-------|----------|-----X-X-----|-----|-------B-----o------T--T--|-------|-----T-------|-B----T-------|--TB-T-----T---------T-------XTX---T-----B--X-T---|--------f
mB---E|-o-------o---|--|---|------X------T--|---X------|-X----T------|-----|-B-------------T----|-X|--|----E--|o----|--T----|----B-|E------|--|--|-----|-----T---|---T----|---E|-----o----|-o-|-------BX
XXXXXXXXXXXXXXXXXXXXXXXXXXXXXXXXXXXXXXXXXXXXXXXXXXXXXXXXXXXXXXXXXXXXXXXXXXXXXXXXXXXXXXXXXXXXXXXXXXXXXXXXXXXXXXXXXXXXXXXXXXXXXXXXXXXXXXXXXXXXXXXXXXXXXXXXXXXXXXXXXXXXXXXXXXXXXXXXXXXXXXXXXXXXXXXXXXXXXXXX
