--------------------------------------------------------------------------------------------------------------------------------------------------------------------------------------------------------
---?-MMo-E?-oBBXEoM-EB?-oM??M-XX-----XBMX----Eo?B-BX-??B-M-?BX??B----?---X--M-X?E-E?--o-MBX---B-XXEo-?--M--MEEE-M--?-X?-BMo?EMXo--Bo-BE--EEM--EM-M----X--B--MBE?--?oXo-MM?-EE?-XEXE--M-?E??oE---o----MM-
--oMMBE-?o-E?-?X-BoE-BXEE?--?-EX----M-EEEoM-XX?M--M-BE?MBB--XXM-oo??--BBoM-M-o?o----T-ME?XE?BX-X-o-oo----XB??-?----XX?EX-MB?E-X-BX-oXEo?--?oX?-|-o-o---?-E-X?B--XBo-B?-?|-E-B-oo-B--B-B-|?T|--?EME-o-BE-
--TBooBMM---?X-o--BT-MoEBM--|-X--M-?MMBE-oBooMET--B--oX?---MM--oEM-X-oXM-|?X---B-B-Mo-?ooMM-M-?o?-?|XEBoB|-X-E??--M--oM-----o--E--?B-?MXE|MooEB-E-EBBE?--B?E|ToM-TM-MM---XEXoX--oE---X--BoT--|-B-M?M-X?-
-o-BoT-E--M-M--o-E-XE?M-E-oBEo?MEEM-?E-BE-o---T---MEEo--E--oX--EMT--oMEE--MXo-B-o?-E---oEEM?TEMXo-EM-M|X-EXEo--M--?M?-o--oM-M--MEB|?X-?M?---MMMEXBM-|B?-Xo--MEo?XXMB-T--Eo----?---o?B--Mo--BM--MB|-?-E--
-------ME-MX-?X|B-o?ooMB?XMMM?oX??----EM--E--MET---ET-M-X?-oB-M-|M|--E--o-B-----|-oMX-?-E---MEoMX-X-MBEBT-o--oXE--?-|B-M--MM-MX|X---M----B--B---Eo-?XEE?-BB-X??MB---B---E-EMB?E-M----B|M-o-??---B--?-Mo-
-X--XoBo--B---?--E-M--|TBX--XM-X?X-MM-T--?-EMoB--|MB-M-|-XM-T--EE?-Mo-M-XBMB-E-?ToMEM-M?XM--B------?-BB-E-XoB-|-E------?Xo-MBBo--XX-M-MB--TM?Bo-o-B-MM-?-M|--E-M-MX-M-E--o|---E-T-EB-M-XMEBE--MXX?-EMEM-
--BE----oM-M-M-BET-o-MXM-B-XBX--?--X-?ETE--BEMM-?M--XBoTEX---M?MMo--Eo-B-MEXX-M-?TX-XXE-|B-M-MooBM-M-o?BX?-E-BTEE-oo-X-X-|--XEMEo----o-EM-BB--M-BE?E-X-oMB|-E------?-BBMB-E-?-oM-B-EX-?E-?oo?M-?BBMM-X-v
-X|-o--o---oXXE--?-MM?-|---E---B?-o-MM-o?MEE---XXXE--o--M----X-?BX--|BXXE-MXBBoBEX-ET--o---B-EBM---EoE-?oB-BEXoM-??M-??-E-----?-Xo-?--Eo--o---X-E--?-o-BBooo-XX?M-?E-M--E?-BMM-?XBMMX-X-M-X---BM?T-MMXEf
--X?EoX?EB-||o--B|XE-MXBM-X---E--oE-EEBB-B-?-Eo--XBMB?-E--EX-XX|-B-M----?--M-BXMB--?Xo-?-Mo--o-M-Bo--M--BoXB-------B---MM-BXMoBEX--EX-Mo-?XBXE?o--XB---E?T-?-E-XT---B---ME?XE--TBo-MME--??XE?EM-E|MXB-Bf
-XoEEoMBoo-M-?-MT-|-E-M-To--M-BBXEM-??-B-MBT--E--T------MX-ooB-E--XE-E-MMM---E-X--E----M--?EE?BX?BB?|---?M?o-?M-E-M-----B-M-ooEo-Bo-?M---|-oo-?T-X-o--oo-ME?oM-B----XoM--T-T?XB-XXEo-oM--?o-EM-X?--EB-?f
-B----X??M-M-XB|-o?o-----XB-Mo??EEoBMM---E-B-o---B-?-BMX-X-o-o-TE-T?---MB-oX-EM?oo-X-BBMM-TTB?B---M--BB-EB-MMXB--EX-E--M---E-?---XM?XMXB?-MB--BBooo?--?X-XX-?X-EXEMB--oX-XB--oB-o-B|?--oX--BX---|TEM-B-f
-?MMXEo-M-?-XMEMXE?--E?oB?E-E?E?E-----o---EMo-o--E-?-BBTX---?|-oB-?BM?-----E-E-X?EBE?-M---Mo-?--o-TX?--B--BX--o-??--Xo-??--BBEMEo--BB-o|?XM?M-ooMME-X--XMBB--o---|-?-X?--E-|ooEEE-MM-MX-?X---oMB|-BMBB?f
-------?----ToMXM?--MXBE-B---TB-MM-?B-oMM-B-?X--BTE?--B?X-oo|TMo-X-Bo---X--Eo---??|ooBTX|-B-XE--?EM--o-B?B-EBX--XE--Xoo--?-MM-BEBo--XBMoMX-oX-EX-?o-Eo-EX-B----B--oMoE|X-o-oB---X-BEM--oM??B-X-o-?M-XE|f
m?o?--?M?---o-----Xoooo??MB-E-o-MMM?-E-E--EX-?EBE-B?M-B?MoX--MTX-XX-EB-oM-?-TXT|-?ME-??-Xo-B?B-MMTE---X-E-EB-T?--XBXM-B-M-|X-X-EoBX-E?B---M-oB-MMEXX-oXB?BX-o-E-o?EEo-o-M|ET-T--?BX--X?MM-oBo----M-ooT-X
XXXXXXXXXXXXXXXXXXXXXXXXXXXXXXXXXXXXXXXXXXXXXXXXXXXXXXXXXXXXXXXXXXXXXXXXXXXXXXXXXXXXXXXXXXXXXXXXXXXXXXXXXXXXXXXXXXXXXXXXXXXXXXXXXXXXXXXXXXXXXXXXXXXXXXXXXXXXXXXXXXXXXXXXXXXXXXXXXXXXXXXXXXXXXXXXXXXXXXXX
