--------------------------------------------BBBBBBBB-----------M------o-----------------------------------------------------o----------------------------o--------------------------------X-------------
----------------------------------------------------------------------?---------------------------------------------------------------------------------------------------------------------------------
---------------------------------------------------------------------------o---------------??-----?----------------------------------XX-----------------------------------------------------------------
--------------------------------------------------------------------------------------------------------------????---------------------------------------------------B------------------------------o---
------------------------------------X---------------------------------------BBBBoB----------------------------------------------------------------------------------------------------------------------
-------------------------BBBB------XX--------------------------------X----------------------------------------------------------M------------------------------------------------X----------------------
----------------------------------XXX----------------------------------o-----------------------------------------------oM----------M----------B---------------------------------XX----------------------
---------------------------------XXXX----------------------------------------?-------X---------------------------------------o-------------------------------------------------XXX-----o---------------v
---------------------o----------XXXXX------------------------------------------------------------------------X---------------------X-----------o-------?----------------------XXXX---------------------f
---BBBBBB----------------------XXXXXX-------------------------------------------?X------XXXXXXXXXXXX----------------------------B---------------XXX--------------------------XXXXX--X------------------f
------------------------------XXXXXXX--------------------------------------------------------------------------------------------BM-----------------------------------------XXXXXX---------------------f
-----------------------------XXXXXXXX--------------------------?--o--------------------X--------------TT----------------------?-X----------------------?------------------?XXXXTXX------------XXX------f
---------------------T------XXXXXXXXX-----------------------T--------------------o-----------o--------||-------BBBBBB----------------------------???T-X-------------------XXXXX|XX--------B------------f
-------------------T-|--???XXXXXXXXXX-----------------------|------------------------X----------------||????--------------?-------------------------|--------------------XXXXXX|XX---------------------f
mE----------------E|-|---EXXXXXXXXXXX-------------------E---|-------E----------E----XX-E-E------------||------E---E---------E---EEE----M------------|--------M----------XXXXXXX|XX---------------------X
XXXXXXXXXXXXXXXXXXX|X|XXXXXXXXXXXXXXXXXXXXXXXXXXXXXXXXXXoXXX|-------???-----??----XXXX-XXX-----XXXXXXB||o------XXXXXXXXXXXXX-XXXXXXXXXXXXXXXXXXXXXXX|XX-XXX----XXXXXXXXXXXXXXXX|XX----XXXXXXXXXXXXXXXXXX