---------------------------------------------------------------B----------------------------------------------------------------------------------------------------------------------------------------
-----------------------------------------------B-----------------------------------------------?--------------------------------------------------------------------------------------------------------
-------------------------------------------------------------------------------------------------------------------------------------??????-------------------------------------------------------------
---------------------------------------------------------------------------------------???????----------------------------------------------------------------------------------------------------------
--------------------------------------------------------------------------------------------------------------------------------------------------------------------------------------------------------
--------------------------------------------------------------------------------------------------------------------------------------------------------------------------------------------------------
------------------------------o------------------------------------------------------------------------------?------------------------------------------X-----------------------------------------------
--X--------------------------------------------------o-------------------------------------------------------------------------------------------------XX------------------------------------B---------v
-----------------------------------------------------------------------?------------------------------------------------------------------------------XXX----------------------------------------------f
----------------?----------------------------------------------------------------M------------------------------------------?------------------------XXXX--------------------X-------------------------f
--------------------------------------------------------------------------------------X-------------------------------------------------------------XXXXX----------------------------------------------f
-T----------------T---------------------T------------------------BBBBBB----------------------------------------------------------------------------XXXXXX----------------------------------------------f
-|----------------|---------------------|BBBBB--------------------XXXXXXXX--------------X----o-----------------------------T--------T-------------XXXXXXX----------------------------------------------f
-|----------------|---------------------|-----------------------------------------------XX-----------------M---------------|--------|------------XXXXXXXX---BBBXBBB------------------------------------f
m|----------------|-------------E-------|-E--------------XXXXXX-------------------B-----XXX-------------------------------E|--------|-------E---XXXXXXXXX-----XX---------------------------------------X
X|XXXXXXXXXXXXXXXX|XXXXXXXXXXXXXXXXXXXXX|--XXXXXXXXXXXXXXXXXXXXXXXXXXXXXX--------XXXXXXXXXXXXXXXXXMXXXXXXXXXXXXXXXXXXXXXXXX|XX------|XXXXXXXXXXXXXXXXXXXXXXXXXXXXXXXXXXXXXXXXXXXXXXXXXXXXXXXXXXXX----XXX
