--------------------------------------------------------------------------------------------------------------------------------------------------------------------------------------------------------
--M-----X----M--X---o-M--o---MB-B------------o-E-M-X-?-----?-M---?E?------X--Bo--B------ME-B------?X-X?ME--E-----?-o---X---B----o?M-E---E?-----Eo---o-X------BE---B---?-----o----o-M----MB-o----B---BEE-
-EM--M--EM??--?X--M---M-?EoM--B---MoX-o--o-X--------MX--B-B?E--X--E-------oo-----oE-o-o-|--------Mo-M---?M-M------M---o?-------B---X----------?-X-M-----------|EE-?-X-X----Bo--X-MEM-----Mo-ME--M-------
-?--X---M---oM--X----M--Mo--?--??M-?-??-B-M-B-X----?---ME-E--E-E-?--X---M-?-----------------BEE------o---X?----B----o-B-------o-X-o-MBE-------E---E---Mo----M-MMB----E?B-E-----X-X-----?-XB-o----EXE-?M-
-o------E-E-?-oM-?---M--MXBE?-oE-E-M------E---XE-XoX-?oBM?--o-B--------X----M------E-E-Eo---B-----E--------o--BXXX--ME-------X---M-----------?-----oB--o-B---?---------XM--BMX---------o---E--?X------M-
-MM-X---o-----E------E------------M-----o-EBM?--E---o-----?---------X-----EoX----?o--X-o?-------B-o?M--?o------oE-B-o-----B--------EoM-?B-----M-M---o-----E--E-MM--XX--o-?--B----B--?--M--X----MoX-oo?E-
-EE?-MBMXE---Eo-oE-X-o-M?-B---EB-M--X--o--M----------M----B--oo--?E-----X--B----E?B-E---oB----B---B-E---?--o?-E-?-Xoo----?---M?EM--?--Mo------?M---------M--?--B-M-E----?-E------oX--B--?---o---To------
----Bo-E---o-B?--o-----E?oXo-B----?X-BB?E--M-XE--------X--?--B-o--------M-ME-?-B-|T-?---|--------M---?-Bo--M---?--E--BM-?X--B-----X---MB?---B-o--E----B----M-----oBM-------MX-----?-----M--------E----Bv
-------M-?------------Mo---BE-B---o----------?----E-M--o-M---o-BBB--BX-BoBBE----M--E?------B--X--B---XX--E-----M-o?-------X--B--EBM----M-?---o-oBEoo-E----EB---oBEB--o?-B??-?M---------MM-----------E--f
---E-o--EX-o--oM-o-X--M--------o------------X-------XB---MoM-XoMXX---B-T--?--X---o-o---M-----EX-E-EB--E-------o--X-M-oo--?-------oE-----o-BXMo-M-Xo----X-oB-B------E----?--M--X?--M-B-o-M----?X--------f
-X-?------?o-X-EE--EX-EE-?---E-------------M----X?B-Bo--X--B---X------?M----?-?X?|--E--B-BXE-E--oo--BX--XB-------B---BM--M-o--B-EoT-M--M---MM------o--o-----E-----------X-o---EX----BB--B----X-o---o--Bf
----------?B--X---MMM-------X?X-?---XXM-----??B--?----M--?--MB---B---o-?--Eo-----E-M-M--B-M-oX--------M-o---EE--E-M-BBM-Xo------E----BX?XXB-|---o---E----B?----?-??EE-o-M-M---oX-E---|---------X-EoM---f
--MX---?-?----E------Booo-M--oB---o--B--?--Bo-E-----?-oo---X-?M---------o-oTE--o-----oB--X----?----o-----Bo-o?-B--M------T----?---------o?--EoB--B--?-o-----BMo----------BB-----?-X-?-----B--o---?----Bf
----XMo------B------oo-BT--oEo----M-----oM----E---E-Xo---X-??Bo------BX---o--B-X-?---o---Xo-B-o-X-M----E-T-----E--E------?---M--?o------E------E--o?--o?----?----o-------------XE--o---------X--------of
m?-B-X---B-----o-B-oE-----------M--M-----B---Bo-XE--TE-E---E------E-BBM-E--EM--B-?X-ME-M---E---MX------o------E--?-----X-EX---X-M-oM---E---M----?BB----?--------oE---------------o----B-?----X--EXoX-X-X
XXXXXXXXXXXXXXXXXXXXXXXXXXXXXXXXXXXXXXXXXXXXXXXXXXXXXXXXXXXXXXXXXXXXXXXXXXXXXXXXXXXXXXXXXXXXXXXXXXXXXXXXXXXXXXXXXXXXXXXXXXXXXXXXXXXXXXXXXXXXXXXXXXXXXXXXXXXXXXXXXXXXXXXXXXXXXXXXXXXXXXXXXXXXXXXXXXXXXXXX
